{
    "tiles": [
        89,89,89,89,89,89,89,89,89,89,89,89,89,89,89,89,89,211,209,89,89,211,209,89,89,89,89,89,89,89,89,89,89,89,89,89,89,89,89,89,
        250,250,250,250,250,250,250,250,250,250,250,250,250,250,250,250,250,251,249,250,250,251,249,250,250,250,250,250,250,250,250,250,250,250,250,250,250,250,250,250,
        0,0,0,0,0,0,0,0,0,0,0,0,0,0,0,0,0,0,0,0,0,0,0,0,0,0,0,0,0,0,0,0,0,0,0,0,0,0,0,0,
        0,0,0,0,0,0,0,0,0,0,0,0,0,0,0,0,0,0,0,0,0,0,0,0,0,0,0,0,0,0,0,0,0,0,0,0,0,0,0,0,
        0,0,0,0,0,0,0,0,0,0,0,0,0,0,0,0,0,0,0,0,0,0,0,0,0,0,0,0,0,0,0,0,0,0,0,0,0,0,0,0,
        0,0,0,0,0,0,0,0,0,0,0,0,0,0,0,0,0,0,0,0,0,0,0,0,0,0,0,0,0,0,0,0,0,0,0,0,0,0,0,0,
        170,170,170,170,170,170,170,170,170,170,170,170,170,170,170,170,170,171,169,170,170,171,0,0,0,169,170,170,170,170,170,170,170,170,170,170,170,170,170,170,
        89,89,89,89,89,89,89,89,89,89,89,89,89,89,89,89,89,211,209,89,89,211,0,0,0,209,89,89,89,89,89,89,89,89,89,89,89,89,89,89,
        250,250,250,250,250,250,250,250,250,250,250,250,250,250,250,250,250,251,209,89,89,211,0,0,0,249,250,250,250,250,250,250,250,250,250,250,250,250,250,250,
        0,0,0,0,0,0,0,0,0,0,0,0,0,0,0,0,0,0,249,250,250,251,0,0,0,0,0,0,0,0,0,0,0,0,0,0,0,0,0,0,
        0,0,0,0,0,0,0,0,0,0,0,0,0,0,0,0,0,0,7,7,7,7,0,0,0,0,0,0,0,0,0,0,0,0,0,0,0,0,0,0,
        0,0,0,0,0,0,0,0,0,0,0,0,0,0,0,0,0,0,6,6,6,6,0,0,0,0,0,0,0,0,0,0,0,0,0,0,0,0,0,0,
        0,0,0,0,0,0,0,0,0,0,0,0,0,0,0,0,0,0,169,170,170,171,0,0,0,0,0,0,0,0,0,0,0,0,0,0,0,0,0,0,
        170,170,170,170,170,170,170,170,170,170,170,170,170,170,171,0,0,0,209,89,89,211,169,170,170,170,170,170,170,170,170,170,170,170,170,170,170,170,170,170,
        89,89,89,89,89,89,89,89,89,89,89,89,89,89,211,0,0,0,209,89,89,211,209,89,89,89,89,89,89,89,89,89,89,89,89,89,89,89,89,89,
        250,250,250,250,250,250,250,250,250,250,250,250,250,250,251,0,0,0,209,89,89,211,249,250,250,250,250,250,250,250,250,250,250,250,250,250,250,250,250,250,
        0,0,0,0,0,0,0,0,0,0,0,0,0,0,0,0,0,0,249,250,250,251,0,0,0,0,0,0,0,0,0,0,0,0,0,0,0,0,0,0,
        0,0,0,0,0,0,0,0,0,0,0,0,0,0,0,0,0,0,7,7,7,7,0,0,0,0,0,0,0,0,0,0,0,0,0,0,0,0,0,0,
        0,0,0,0,0,0,0,0,0,0,0,0,0,0,0,0,0,0,6,6,6,6,0,0,0,0,0,0,0,0,0,0,0,0,0,0,0,0,0,0,
        0,0,0,0,0,0,0,0,0,0,0,0,0,0,0,0,0,0,169,170,170,171,0,0,0,0,0,0,0,0,0,0,0,0,0,0,0,0,0,0,
        170,170,170,170,170,170,170,170,170,170,170,170,170,170,170,170,170,171,209,89,89,211,0,0,0,169,170,170,170,170,170,170,170,170,170,170,170,170,170,170,
        89,89,89,89,89,89,89,89,89,89,89,89,89,89,89,89,89,211,209,89,89,211,0,0,0,209,89,89,89,89,89,89,89,89,89,89,89,89,89,89,
        250,250,250,250,250,250,250,250,250,250,250,250,250,250,250,250,250,251,249,250,250,251,0,0,0,249,250,250,250,250,250,250,250,250,250,250,250,250,250,250,
        0,0,0,0,0,0,0,0,0,0,0,0,0,0,0,0,0,0,0,0,0,0,0,0,0,0,0,0,0,0,0,0,0,0,0,0,0,0,0,0,
        0,0,0,0,0,0,0,0,0,0,0,0,0,0,0,0,0,0,0,0,0,0,0,0,0,0,0,0,0,0,0,0,0,0,0,0,0,0,0,0,
        0,0,0,0,0,0,0,0,0,0,0,0,0,0,0,0,0,0,0,0,0,0,0,0,0,0,0,0,0,0,0,0,0,0,0,0,0,0,0,0,
        0,0,0,0,0,0,0,0,0,0,0,0,0,0,0,0,0,0,0,0,0,0,0,0,0,0,0,0,0,0,0,0,0,0,0,0,0,0,0,0,
        170,170,170,170,170,170,170,170,170,170,170,170,170,170,170,170,170,171,169,170,170,171,169,170,170,170,170,170,170,170,170,171,0,0,0,0,169,170,170,170,
        89,89,89,89,89,89,89,89,89,89,89,89,89,89,89,89,89,211,209,89,89,211,209,89,89,89,89,89,89,89,89,211,0,0,0,0,209,89,89,89,
        89,89,89,89,89,89,89,89,89,89,89,89,89,89,89,89,89,211,209,89,89,211,209,89,89,89,89,89,89,89,89,211,0,0,0,0,209,89,89,89],
    "name": "Sweeney's Maze"
 }