{
    "tiles": [
        83,83,83,205,0,0,0,0,203,205,0,0,0,0,203,205,0,0,0,0,203,205,0,0,0,0,203,205,0,0,0,0,203,205,0,0,0,0,203,83,
        244,244,244,245,0,0,0,0,203,205,0,0,0,0,203,205,0,0,0,0,203,205,0,0,0,0,243,245,0,0,0,0,243,245,0,0,0,0,203,83,
        0,0,0,0,0,0,0,0,203,205,0,0,0,0,203,205,0,0,0,0,203,205,0,0,0,0,0,0,0,0,0,0,0,0,0,0,0,0,203,83,
        0,0,0,0,0,0,0,0,203,205,0,0,0,0,203,205,0,0,0,0,203,205,0,0,0,0,0,0,0,0,0,0,0,0,0,0,0,0,203,83,
        0,0,0,0,0,0,0,0,203,205,0,0,0,0,203,205,0,0,0,0,203,205,0,0,0,0,0,0,0,0,0,0,0,0,0,0,0,0,203,83,
        0,0,0,0,0,0,0,0,203,205,0,0,0,0,243,245,0,0,0,0,243,245,0,0,0,0,0,0,0,0,0,0,0,0,0,0,0,0,203,83,
        164,164,164,165,0,0,0,0,203,205,0,0,0,0,163,164,165,163,164,164,164,164,164,164,164,164,164,164,164,164,165,163,164,165,0,0,0,0,203,83,
        83,83,83,205,0,0,0,0,243,245,0,0,0,0,203,83,205,203,83,83,83,83,83,83,83,83,83,83,83,83,205,203,83,205,0,0,0,0,203,83,
        83,83,83,205,0,0,0,0,0,0,0,0,0,0,243,244,245,243,244,244,244,244,244,244,244,244,244,244,244,244,245,243,244,245,0,0,0,0,203,83,
        83,83,83,205,0,0,0,0,0,0,0,0,0,0,163,164,164,164,164,164,164,164,164,165,7,7,7,7,7,7,7,7,163,165,0,0,0,0,203,83,
        83,83,83,205,0,0,0,0,0,0,0,0,0,0,243,244,244,244,244,244,244,244,244,245,0,0,0,0,0,0,0,0,243,245,0,0,0,0,203,83,
        83,83,83,205,0,0,0,0,0,0,0,0,0,0,0,0,0,0,0,0,0,0,0,0,0,0,0,0,0,0,0,0,0,0,0,0,0,0,203,83,
        83,83,83,205,0,0,0,0,0,0,0,0,0,0,0,0,0,0,0,0,0,0,0,0,0,0,0,0,0,0,0,0,0,0,0,0,0,0,203,83,
        83,83,83,205,0,0,0,0,0,0,0,0,0,0,0,0,0,0,0,0,0,0,0,0,0,0,0,0,0,0,0,0,0,0,0,0,0,0,203,83,
        83,83,83,205,0,0,0,0,163,165,0,0,0,0,0,0,0,0,0,0,0,0,0,0,0,0,0,0,0,0,0,0,0,0,0,0,0,0,203,83,
        83,83,83,205,0,0,0,0,203,205,0,0,0,0,0,0,0,0,0,0,0,0,0,0,0,0,0,0,0,0,0,0,0,0,0,0,0,0,203,83,
        83,83,83,205,0,0,0,0,203,205,0,0,0,0,0,0,0,0,0,0,0,0,0,0,0,0,0,0,0,0,0,0,0,0,0,0,0,0,203,83,
        83,83,83,205,0,0,0,0,203,205,0,0,0,0,0,0,0,0,0,0,0,0,0,0,0,0,0,0,0,0,0,0,0,0,0,0,0,0,203,83,
        83,83,83,205,0,0,0,0,203,205,0,0,0,0,163,165,0,0,0,0,0,0,0,0,163,164,164,164,164,164,164,164,164,165,0,0,0,0,203,83,
        83,83,83,205,0,0,0,0,203,205,0,0,0,0,243,245,6,6,6,6,6,6,6,6,243,244,244,244,244,244,244,244,244,245,0,0,0,0,203,83,
        83,83,83,205,0,0,0,0,203,205,0,0,0,0,163,164,165,163,164,164,164,164,164,164,164,164,164,164,164,164,165,163,164,165,0,0,0,0,203,83,
        83,83,83,205,0,0,0,0,203,205,0,0,0,0,203,83,205,203,83,83,83,83,83,83,83,83,83,83,83,83,205,203,83,205,0,0,0,0,203,83,
        83,83,83,205,0,0,0,0,203,205,0,0,0,0,243,244,245,243,244,244,244,244,244,244,244,244,244,244,244,244,245,243,244,245,0,0,0,0,203,83,
        83,83,83,205,0,0,0,0,203,205,0,0,0,0,163,165,0,0,0,0,0,0,0,0,0,0,0,0,0,0,0,0,163,165,0,0,0,0,203,83,
        83,83,83,205,0,0,0,0,203,205,0,0,0,0,203,205,0,0,0,0,0,0,0,0,0,0,0,0,0,0,0,0,203,205,0,0,0,0,203,83,
        83,83,83,205,0,0,0,0,203,205,0,0,0,0,203,205,0,0,0,0,0,0,0,0,0,0,0,0,0,0,0,0,203,205,0,0,0,0,203,83,
        83,83,83,205,0,0,0,0,203,205,0,0,0,0,203,205,0,0,0,0,0,0,0,0,0,0,0,0,0,0,0,0,203,205,0,0,0,0,203,83,
        83,83,83,205,0,0,0,0,203,205,0,0,0,0,203,205,0,0,0,0,163,165,0,0,0,0,163,165,0,0,0,0,203,205,0,0,0,0,203,83,
        83,83,83,205,0,0,0,0,203,205,0,0,0,0,203,205,0,0,0,0,203,205,0,0,0,0,203,205,0,0,0,0,203,205,0,0,0,0,203,83,
        83,83,83,205,0,0,0,0,203,205,0,0,0,0,203,205,0,0,0,0,203,205,0,0,0,0,203,205,0,0,0,0,203,205,0,0,0,0,203,83],
    "name": "Shockwave Rider"
 }