{
    "tiles": [
        212,92,92,214,252,253,253,254,212,92,92,214,212,92,92,214,212,92,92,214,212,92,92,214,212,92,92,214,212,92,92,214,212,92,92,214,212,92,92,214,
        212,92,92,214,0,0,0,0,252,253,253,254,212,92,92,214,212,92,92,214,212,92,92,214,212,92,92,214,212,92,92,214,212,92,92,214,212,92,92,214,
        212,92,92,214,0,0,0,0,0,0,0,0,252,253,253,254,212,92,92,214,212,92,92,214,212,92,92,214,212,92,92,214,212,92,92,214,212,92,92,214,
        212,92,92,214,0,0,0,0,0,0,0,0,0,0,0,0,212,92,92,214,212,92,92,214,212,92,92,214,212,92,92,214,212,92,92,214,212,92,92,214,
        212,92,92,214,0,0,0,0,0,0,0,0,0,0,0,0,212,92,92,214,252,253,253,254,212,92,92,214,212,92,92,214,212,92,92,214,212,92,92,214,
        212,92,92,214,0,0,0,0,0,0,0,0,0,0,0,0,212,92,92,214,0,0,0,0,252,253,253,254,212,92,92,214,212,92,92,214,212,92,92,214,
        212,92,92,214,0,0,0,0,0,0,0,0,0,0,0,0,212,92,92,214,0,0,0,0,0,0,0,0,252,253,253,254,212,92,92,214,212,92,92,214,
        212,92,92,214,0,0,0,0,0,0,0,0,0,0,0,0,212,92,92,214,0,0,0,0,0,0,0,0,0,0,0,0,212,92,92,214,212,92,92,214,
        252,253,253,254,0,0,0,0,0,0,0,0,0,0,0,0,252,253,253,254,0,0,0,0,0,0,0,0,0,0,0,0,212,92,92,214,252,253,253,254,
        0,0,0,0,0,0,0,0,172,173,173,174,0,0,0,0,0,0,0,0,0,0,0,0,0,0,0,0,0,0,0,0,212,92,92,214,0,0,0,0,
        0,0,0,0,0,0,0,0,212,92,92,214,0,0,0,0,0,0,0,0,0,0,0,0,0,0,0,0,0,0,0,0,212,92,92,214,0,0,0,0,
        0,0,0,0,0,0,0,0,212,92,92,214,0,0,0,0,172,173,173,174,0,0,0,0,0,0,0,0,0,0,0,0,212,92,92,214,0,0,0,0,
        0,0,0,0,0,0,0,0,212,92,92,214,0,0,0,0,252,253,253,254,0,0,0,0,0,0,0,0,0,0,0,0,212,92,92,214,0,0,0,0,
        0,0,0,0,0,0,0,0,212,92,92,214,0,0,0,0,0,0,0,0,0,0,0,0,172,173,173,174,0,0,0,0,212,92,92,214,0,0,0,0,
        0,0,0,0,0,0,0,0,212,92,92,214,0,0,0,0,0,0,0,0,0,0,0,0,252,253,253,254,0,0,0,0,212,92,92,214,0,0,0,0,
        0,0,0,0,0,0,0,0,212,92,92,214,0,0,0,0,0,0,0,0,0,0,0,0,0,0,0,0,0,0,0,0,212,92,92,214,0,0,0,0,
        172,173,173,174,0,0,0,0,212,92,92,214,0,0,0,0,0,0,0,0,0,0,0,0,0,0,0,0,0,0,0,0,252,253,253,254,172,173,173,174,
        252,253,253,254,172,173,173,174,212,92,92,214,0,0,0,0,0,0,0,0,0,0,0,0,172,173,173,174,0,0,0,0,0,0,0,0,252,253,253,254,
        0,0,0,0,252,253,253,254,212,92,92,214,0,0,0,0,0,0,0,0,0,0,0,0,212,92,92,214,0,0,0,0,0,0,0,0,0,0,0,0,
        0,0,0,0,0,0,0,0,252,253,253,254,172,173,173,174,0,0,0,0,0,0,0,0,212,92,92,214,0,0,0,0,0,0,0,0,0,0,0,0,
        0,0,0,0,0,0,0,0,0,0,0,0,252,253,253,254,172,173,173,174,0,0,0,0,212,92,92,214,0,0,0,0,0,0,0,0,0,0,0,0,
        0,0,0,0,0,0,0,0,0,0,0,0,0,0,0,0,252,253,253,254,172,173,173,174,212,92,92,214,0,0,0,0,0,0,0,0,0,0,0,0,
        0,0,0,0,0,0,0,0,0,0,0,0,0,0,0,0,0,0,0,0,212,92,92,214,212,92,92,214,0,0,0,0,0,0,0,0,0,0,0,0,
        0,0,0,0,0,0,0,0,0,0,0,0,0,0,0,0,0,0,0,0,212,92,92,214,212,92,92,214,172,173,173,174,0,0,0,0,0,0,0,0,
        0,0,0,0,0,0,0,0,0,0,0,0,0,0,0,0,0,0,0,0,212,92,92,214,212,92,92,214,212,92,92,214,172,173,173,174,0,0,0,0,
        172,173,173,174,0,0,0,0,0,0,0,0,0,0,0,0,0,0,0,0,212,92,92,214,212,92,92,214,212,92,92,214,212,92,92,214,172,173,173,174,
        212,92,92,214,172,173,173,174,0,0,0,0,0,0,0,0,0,0,0,0,212,92,92,214,212,92,92,214,212,92,92,214,212,92,92,214,212,92,92,214,
        212,92,92,214,212,92,92,214,172,173,173,174,0,0,0,0,0,0,0,0,212,92,92,214,212,92,92,214,212,92,92,214,212,92,92,214,212,92,92,214,
        212,92,92,214,212,92,92,214,212,92,92,214,172,173,173,174,0,0,0,0,212,92,92,214,212,92,92,214,212,92,92,214,212,92,92,214,212,92,92,214,
        212,92,92,214,212,92,92,214,212,92,92,214,212,92,92,214,0,0,0,0,212,92,92,214,212,92,92,214,212,92,92,214,212,92,92,214,212,92,92,214],
    "name": "Ascending and Descending"
 }