{
    "tiles": [
        92,92,92,92,92,92,92,92,92,92,92,92,92,92,92,92,92,92,92,92,92,92,92,92,92,92,92,92,92,92,92,92,92,92,92,92,92,92,92,92,
        92,92,92,92,92,92,92,92,92,92,92,92,92,92,92,92,92,92,92,92,92,92,92,92,92,92,92,92,92,92,92,92,92,92,93,253,253,253,253,253,
        92,92,92,92,92,92,93,253,253,253,253,253,253,253,253,253,253,253,253,253,253,253,253,253,253,253,253,253,253,253,253,253,253,253,254,9,9,9,9,9,
        92,92,92,92,92,92,214,0,0,0,0,0,0,0,0,0,0,0,0,0,0,0,0,0,0,0,0,0,0,0,0,0,0,0,0,0,0,0,0,0,
        92,92,92,92,92,92,214,0,0,0,0,0,0,0,0,0,0,0,0,0,0,0,0,0,0,0,0,0,0,0,0,0,0,0,0,0,0,0,0,0,
        92,92,92,92,92,92,214,0,0,0,0,0,0,0,0,0,0,0,0,0,0,0,0,0,0,0,0,0,0,0,0,0,0,0,0,0,0,0,0,0,
        92,92,92,92,92,92,214,0,0,0,0,0,0,0,0,0,0,0,0,0,0,0,0,0,0,0,0,0,0,0,0,0,0,0,0,0,0,0,0,0,
        92,92,92,92,92,92,214,0,0,0,0,0,0,0,0,0,0,0,0,0,0,0,0,0,0,0,0,0,0,0,0,0,0,0,0,0,0,0,0,0,
        92,92,92,92,92,92,214,0,0,0,0,0,0,0,0,0,0,0,0,0,0,0,0,0,0,0,0,0,0,0,0,0,0,0,0,0,0,0,0,0,
        92,92,92,92,92,92,214,0,0,0,0,0,0,0,0,0,0,0,0,0,0,0,0,0,0,0,0,0,0,0,0,0,0,0,0,0,0,0,0,0,
        92,92,92,92,92,92,214,0,0,0,0,172,173,173,173,173,173,173,173,173,173,173,173,173,173,173,173,173,173,173,173,173,173,173,173,173,173,173,173,173,
        92,92,92,92,92,92,214,0,0,0,0,212,92,92,92,92,92,92,92,92,92,92,92,92,92,92,92,92,92,92,92,92,92,92,92,92,92,92,92,92,
        92,92,92,92,92,92,214,0,0,0,0,212,92,92,92,92,92,92,92,92,92,92,92,92,92,92,92,92,92,92,92,92,92,92,92,92,92,92,92,92,
        92,92,92,92,92,92,214,0,0,763,764,212,92,92,92,92,92,92,92,92,92,92,92,92,92,92,93,253,253,253,253,253,253,253,253,253,253,253,253,253,
        92,92,92,92,92,92,214,0,0,803,683,212,92,92,92,92,92,92,92,92,92,92,92,92,92,92,214,0,0,0,0,0,0,0,0,0,0,0,0,0,
        92,92,92,92,92,92,214,0,0,803,683,212,92,92,92,92,92,92,92,92,92,92,92,92,92,92,214,0,0,0,0,0,0,0,0,0,0,0,0,0,
        92,92,92,92,92,92,214,0,0,803,683,212,92,92,92,92,92,92,92,92,92,92,92,92,92,92,214,0,0,0,0,0,0,0,0,0,0,0,0,0,
        92,92,92,92,92,92,214,0,0,803,683,212,92,92,92,92,92,92,92,92,92,92,92,92,92,92,214,0,0,0,0,0,0,0,0,0,0,0,0,0,
        92,92,92,92,92,92,214,0,0,803,683,212,92,92,92,92,92,92,92,92,92,92,92,92,92,92,214,0,0,0,0,0,0,0,0,0,0,0,0,0,
        92,92,92,92,92,92,214,0,0,803,683,212,92,92,92,92,92,92,92,92,92,92,92,92,92,92,214,0,0,0,0,0,0,0,0,0,0,0,0,0,
        92,92,92,92,92,92,214,0,0,803,683,212,92,92,93,253,253,253,253,253,253,253,253,253,253,253,254,0,0,0,0,0,0,0,0,0,0,0,0,0,
        92,92,92,92,92,92,214,0,0,803,683,212,92,92,214,0,0,0,0,0,0,0,0,0,0,0,0,0,0,0,0,0,0,0,0,0,172,173,173,173,
        92,92,92,92,92,92,214,0,0,803,683,212,92,92,214,683,683,683,683,683,683,683,683,805,0,0,0,0,0,0,0,0,0,0,0,0,212,92,92,92,
        92,92,92,92,92,92,214,0,0,803,683,212,92,92,214,683,683,683,683,683,683,683,683,805,0,0,0,0,0,0,0,0,0,0,0,0,212,92,92,92,
        92,92,92,92,92,92,214,0,0,803,683,212,92,92,214,683,683,683,683,683,683,683,683,805,0,0,0,0,0,0,0,0,0,0,0,0,212,92,92,92,
        92,92,92,92,92,92,214,0,0,803,683,212,92,92,214,683,683,683,683,683,683,683,683,805,0,0,0,0,0,0,0,0,0,0,0,0,212,92,92,92,
        92,92,92,92,92,92,214,0,0,803,683,212,92,92,214,683,683,683,683,683,683,683,683,805,0,0,0,0,0,0,0,0,0,0,0,0,212,92,92,92,
        92,92,92,92,92,92,214,0,0,803,683,212,92,92,214,683,683,683,683,683,0,0,0,0,0,0,0,0,0,0,0,0,0,0,0,0,212,92,92,92,
        92,92,92,92,92,92,214,0,0,803,683,212,92,92,214,683,683,683,683,683,172,173,173,173,173,173,173,173,173,173,173,174,0,0,0,0,212,92,92,92,
        92,92,92,92,92,92,214,0,0,803,683,212,92,92,214,683,683,683,683,683,212,92,92,92,92,92,92,92,92,92,92,214,0,0,0,0,212,92,92,92],
    "name": "Upstream Downstream"
 }