{
    "tiles": [
        283,283,283,283,283,405,0,0,0,0,0,0,403,283,283,283,283,283,283,283,283,283,283,283,283,283,283,283,283,283,283,283,283,283,283,283,283,283,283,283,
        283,283,283,283,283,405,0,0,0,0,0,0,403,283,283,283,283,283,283,283,283,283,283,283,283,283,283,283,283,283,283,283,283,283,283,283,283,283,283,283,
        283,283,283,283,283,405,0,0,0,0,0,0,403,283,283,283,283,283,283,283,283,283,283,283,283,283,283,283,283,283,283,283,283,283,283,283,283,283,283,283,
        283,283,283,283,283,405,0,0,0,0,0,0,403,283,283,283,283,283,283,283,283,283,283,283,283,283,283,283,283,283,283,283,283,283,283,283,283,283,283,283,
        283,283,283,283,283,405,0,0,0,0,0,0,403,283,283,283,283,283,283,283,283,283,283,283,283,283,283,283,283,283,283,283,283,283,283,283,283,283,283,283,
        283,283,283,283,283,405,0,0,0,0,0,0,443,444,444,444,444,444,444,444,444,444,444,444,444,444,285,283,284,444,444,444,444,444,444,444,444,444,444,444,
        283,283,283,283,283,405,0,0,0,0,0,0,9,9,9,9,9,9,9,9,9,9,9,9,9,9,403,283,405,0,0,0,0,0,815,695,695,695,695,695,
        283,283,283,283,283,405,0,0,0,0,0,0,0,0,0,0,0,0,0,0,0,0,0,0,0,0,443,444,445,0,0,0,0,0,815,695,695,695,695,695,
        283,283,283,283,283,405,0,0,0,0,0,0,0,0,0,0,0,0,0,0,0,0,0,0,0,0,0,0,0,0,0,0,0,0,815,695,695,695,695,695,
        283,283,283,283,283,405,0,0,0,0,0,0,0,0,0,0,0,0,0,0,0,0,0,0,0,0,0,0,0,0,0,0,0,0,815,695,695,695,695,695,
        283,283,283,283,283,405,0,0,0,0,0,0,0,0,0,0,0,0,0,0,0,0,0,0,0,0,0,0,0,0,0,0,0,0,815,695,695,695,695,695,
        283,283,283,283,283,405,0,0,0,0,0,0,0,0,0,0,0,0,0,0,0,0,0,0,0,0,0,0,0,0,0,0,0,363,364,364,364,364,364,364,
        283,283,283,283,283,405,0,0,0,0,0,0,0,0,0,0,0,0,0,0,0,0,0,0,0,0,0,0,0,0,0,0,0,403,283,283,283,283,283,283,
        283,283,283,283,283,405,0,0,0,0,0,0,0,0,0,0,0,0,0,0,0,0,0,0,0,0,0,0,0,0,0,0,0,403,283,283,283,283,283,283,
        283,283,283,283,283,405,0,0,0,0,0,0,0,0,0,0,0,0,0,0,0,0,0,0,0,0,0,0,0,0,0,0,0,403,283,283,283,283,283,283,
        283,283,283,283,283,324,364,364,364,364,364,364,364,364,364,364,365,8,8,8,8,363,364,364,364,364,364,364,364,364,364,364,364,325,283,283,283,283,283,283,
        283,283,283,283,283,283,283,283,283,283,283,283,283,283,283,283,324,364,364,364,364,325,283,283,283,283,283,283,283,283,283,283,283,283,283,283,283,283,283,283,
        283,283,283,283,283,284,444,444,444,444,444,444,444,444,444,444,444,444,444,444,444,444,444,444,444,444,444,444,444,444,444,444,285,283,283,283,283,283,283,283,
        283,283,283,283,283,405,9,9,9,9,9,9,9,9,9,9,9,9,9,9,9,9,9,9,9,9,9,9,9,9,9,9,403,283,283,283,283,283,283,283,
        283,283,283,283,283,405,0,0,0,0,0,0,0,0,0,0,0,0,0,0,0,0,0,0,0,0,0,0,0,0,0,0,403,283,283,283,283,283,283,283,
        283,283,283,283,283,405,0,0,0,0,0,0,0,0,0,0,0,0,0,0,0,0,0,0,0,0,0,0,0,0,0,0,443,444,444,444,444,444,444,444,
        283,283,283,283,283,405,0,0,0,0,0,0,0,0,0,0,0,0,0,0,0,0,0,0,0,0,0,0,0,0,0,0,0,0,815,695,695,695,695,695,
        283,283,283,283,283,405,0,0,0,0,0,0,0,0,0,0,0,0,0,0,0,0,0,0,0,0,0,0,0,0,0,0,0,0,815,695,695,695,695,695,
        283,283,283,283,283,405,0,0,0,0,0,0,0,0,0,0,0,0,0,0,0,0,0,0,0,0,0,0,0,0,0,0,0,0,815,695,695,695,695,695,
        283,283,283,283,283,405,0,0,0,0,0,0,0,0,0,0,0,0,0,0,0,0,0,0,0,0,0,0,0,0,0,0,0,0,815,695,695,695,695,695,
        283,283,283,283,283,405,0,0,0,0,0,0,0,0,0,0,0,0,0,0,0,0,0,0,0,0,0,0,0,0,0,0,0,0,815,695,695,695,695,695,
        283,283,283,283,283,405,0,0,0,0,0,0,363,364,365,8,8,8,8,8,8,8,8,8,8,8,8,8,8,8,8,363,364,364,364,364,364,364,364,364,
        283,283,283,283,283,405,0,0,0,0,0,0,403,283,324,364,364,364,364,364,364,364,364,364,364,364,364,364,364,364,364,325,283,283,283,283,283,283,283,283,
        283,283,283,283,283,405,0,0,0,0,0,0,403,283,283,283,283,283,283,283,283,283,283,283,283,283,283,283,283,283,283,283,283,283,283,283,283,283,283,283,
        283,283,283,283,283,405,0,0,0,0,0,0,403,283,283,283,283,283,283,283,283,283,283,283,283,283,283,283,283,283,283,283,283,283,283,283,283,283,283,283],
    "name": "Gantry and Dolly"
 }