{
    "tiles": [
        98,98,98,98,98,98,98,98,98,98,98,98,98,98,98,98,98,98,98,98,98,98,98,98,98,98,98,98,98,98,98,98,98,98,98,98,98,98,98,98,
        259,259,259,259,259,259,259,259,259,259,259,259,100,98,98,98,98,98,98,98,98,98,98,98,98,98,98,99,259,259,259,259,259,259,259,259,100,98,98,98,
        9,9,9,9,9,9,9,9,9,9,9,9,258,259,259,259,259,259,259,259,259,259,259,259,259,259,259,260,7,7,7,7,7,7,7,7,218,98,98,98,
        0,0,0,0,0,0,0,0,0,0,0,0,0,0,0,0,0,0,0,0,0,0,0,0,0,0,0,0,680,680,680,680,680,680,680,680,218,98,98,98,
        0,0,0,0,0,0,0,0,0,0,0,0,0,0,0,0,0,0,0,0,0,0,0,0,0,800,680,680,680,680,680,680,680,680,680,680,218,98,98,98,
        0,0,0,0,0,0,0,0,0,0,0,0,0,0,0,0,0,0,0,0,0,0,0,0,0,800,680,680,680,680,680,680,680,680,680,680,218,98,98,98,
        0,0,0,0,0,0,0,0,0,0,0,0,0,0,0,0,0,0,0,0,0,0,0,0,0,800,680,680,680,680,680,680,680,680,680,680,218,98,98,98,
        0,0,0,0,0,0,0,0,0,0,0,0,0,0,0,0,0,0,0,0,0,0,0,0,0,800,680,680,680,680,680,680,680,680,680,680,218,98,98,98,
        0,0,0,0,0,0,0,0,0,0,0,0,0,0,0,0,0,0,0,0,0,0,0,0,0,800,680,680,680,680,680,680,680,680,680,680,218,98,98,98,
        0,0,0,0,0,0,0,0,0,0,0,0,0,0,0,0,0,0,0,0,0,0,0,0,0,0,0,0,0,0,0,0,680,680,680,680,218,98,98,98,
        179,179,179,179,179,179,179,179,179,179,179,179,179,179,179,180,8,8,8,8,8,8,8,8,178,179,179,179,179,179,179,180,680,680,680,680,218,98,98,98,
        98,98,98,98,98,98,98,98,98,98,98,98,98,98,98,139,179,179,179,179,179,179,179,179,140,98,98,98,98,98,98,220,680,680,680,680,218,98,98,98,
        98,98,98,98,98,98,98,98,98,98,98,98,98,98,98,99,259,259,259,259,259,259,259,259,100,98,98,98,98,98,98,220,680,680,680,680,218,98,98,98,
        259,259,259,259,259,259,259,259,259,259,259,259,259,259,259,260,9,9,9,9,9,9,9,9,258,259,259,259,100,98,98,220,680,680,680,680,218,98,98,98,
        0,0,0,0,0,0,0,0,0,0,0,0,0,0,0,0,0,0,0,0,0,0,0,0,0,0,0,0,218,98,98,220,680,680,680,680,218,98,98,98,
        0,0,0,0,0,0,0,0,0,0,0,0,0,0,0,0,0,0,0,0,0,0,0,0,0,800,680,680,218,98,98,220,680,680,680,680,218,98,98,98,
        0,0,0,0,0,0,0,0,0,0,0,0,0,0,0,0,0,0,0,0,0,0,0,0,0,800,680,680,218,98,98,220,680,680,680,680,218,98,98,98,
        0,0,0,0,0,0,0,0,0,0,0,0,0,0,0,0,0,0,0,0,0,0,0,0,0,800,680,680,218,98,98,220,680,680,680,680,218,98,98,98,
        0,0,0,0,0,0,0,0,0,0,0,0,0,0,0,0,0,0,0,0,0,0,0,0,0,800,680,680,218,98,98,220,680,680,680,680,218,98,98,98,
        0,0,0,0,0,0,0,0,0,0,0,0,0,0,0,0,0,0,0,0,0,0,0,0,0,800,680,680,218,98,98,220,680,680,680,680,218,98,98,98,
        0,0,0,0,0,0,0,0,0,0,0,0,0,0,0,0,0,0,0,0,0,0,0,0,0,800,680,680,218,98,98,220,680,680,680,680,218,98,98,98,
        0,0,0,0,0,0,0,0,0,0,0,0,0,0,0,0,0,0,0,0,0,0,0,0,0,800,680,680,218,98,98,220,680,680,680,680,218,98,98,98,
        179,179,179,180,0,0,0,0,0,0,0,0,0,0,0,0,0,0,0,0,0,0,0,0,0,800,680,680,218,98,98,220,680,680,680,680,218,98,98,98,
        98,98,98,220,0,0,0,0,0,0,0,0,0,0,0,0,0,0,0,0,0,0,0,0,0,840,841,841,218,98,98,220,841,841,841,841,218,98,98,98,
        98,98,98,220,0,0,0,0,0,0,0,0,0,0,0,0,0,0,0,0,0,0,0,0,0,0,0,0,218,98,98,220,0,0,0,0,218,98,98,98,
        98,98,98,220,0,0,0,0,0,0,0,0,0,0,0,0,0,0,0,0,0,0,0,0,0,0,0,0,218,98,98,220,0,0,0,0,218,98,98,98,
        98,98,98,220,0,0,0,0,0,0,0,0,0,0,0,0,0,0,0,0,0,0,0,0,0,0,0,0,218,98,98,220,0,0,0,0,218,98,98,98,
        98,98,98,220,0,0,0,0,0,0,0,0,0,0,0,0,0,0,0,0,0,0,0,0,0,0,0,0,218,98,98,220,0,0,0,0,218,98,98,98,
        98,98,98,220,0,0,0,0,178,179,179,179,179,179,179,179,179,179,179,179,179,179,179,179,179,179,179,179,140,98,98,220,0,0,0,0,218,98,98,98,
        98,98,98,220,0,0,0,0,218,98,98,98,98,98,98,98,98,98,98,98,98,98,98,98,98,98,98,98,98,98,98,220,0,0,0,0,218,98,98,98],
    "name": "The High Road is Low"
 }