{
    "tiles": [
        244,244,244,244,244,244,244,244,244,244,244,244,244,244,244,244,244,244,244,244,244,244,244,244,85,83,83,83,83,83,83,83,83,83,83,83,83,83,83,83,
        0,0,0,0,0,0,0,0,0,0,0,0,0,0,0,0,0,0,0,0,0,0,0,0,243,244,244,244,244,244,244,244,244,244,244,244,244,244,244,244,
        0,0,0,0,0,0,0,0,0,0,0,0,0,0,0,0,0,0,800,680,680,680,680,680,7,7,7,7,7,7,7,7,7,7,7,1125,9,9,9,9,
        0,0,0,0,0,0,0,0,0,0,0,0,0,0,0,0,0,0,800,680,680,680,680,680,680,680,680,680,680,680,680,680,680,680,680,802,0,0,0,0,
        0,0,0,0,0,0,0,0,0,0,0,0,0,0,0,0,0,0,800,680,680,680,680,680,680,680,680,680,680,680,680,680,680,680,680,802,0,0,0,0,
        0,0,0,0,0,0,0,0,0,0,0,0,0,0,0,0,0,0,800,680,680,680,680,680,680,680,680,680,680,680,680,680,680,680,680,802,0,0,0,0,
        0,0,0,0,0,0,0,0,0,0,0,0,0,0,0,0,0,0,800,680,680,680,680,680,680,680,680,680,680,680,680,680,680,680,680,802,0,0,0,0,
        8,8,8,8,0,0,0,0,0,0,0,0,0,0,0,0,0,0,800,680,680,680,680,680,680,680,680,680,680,680,680,680,680,680,680,802,0,0,0,0,
        164,164,164,165,0,0,0,0,0,0,0,0,0,0,0,0,0,0,800,680,680,680,680,680,680,680,680,680,680,680,680,680,680,680,680,802,0,0,0,0,
        83,83,83,205,0,0,0,0,0,0,0,0,0,0,0,0,0,0,800,680,680,680,680,680,680,680,680,680,680,680,680,680,680,680,680,802,0,0,0,0,
        83,83,83,205,0,0,0,0,0,0,0,0,0,0,0,0,0,0,800,680,680,680,680,680,680,680,680,680,680,680,680,680,680,680,680,802,0,0,0,0,
        83,83,83,205,0,0,0,0,0,0,0,0,0,0,0,0,0,0,800,680,680,680,680,680,680,680,680,680,680,680,680,680,680,680,680,802,0,0,0,0,
        83,83,83,205,0,0,0,0,0,0,0,0,0,0,0,0,0,0,800,680,680,680,680,680,680,680,680,680,680,680,680,680,680,680,680,802,0,0,0,0,
        83,83,83,205,0,0,0,0,0,0,0,0,0,0,0,0,0,0,0,0,0,0,0,0,0,0,0,0,0,0,0,0,0,0,0,0,0,0,0,0,
        83,83,83,205,0,0,0,0,0,0,0,0,0,0,0,0,0,0,0,0,0,0,0,0,0,0,0,0,0,0,0,0,0,0,0,0,0,0,0,0,
        83,83,83,205,0,0,0,0,0,0,0,0,0,0,0,0,0,0,800,680,680,680,680,680,680,680,680,680,680,680,680,680,680,680,680,802,0,0,0,0,
        83,83,83,205,0,0,0,0,0,0,0,0,0,0,0,0,0,0,800,680,680,680,680,680,680,680,680,680,680,680,680,680,680,680,680,802,0,0,0,0,
        83,83,83,205,0,0,0,0,0,0,0,0,0,0,0,0,0,0,800,680,680,680,680,680,680,680,680,680,680,680,680,680,680,680,680,802,0,0,0,0,
        83,83,83,205,0,0,0,0,0,0,0,0,0,0,0,0,0,0,800,680,680,680,680,680,680,680,680,680,680,680,680,680,680,680,680,802,0,0,0,0,
        83,83,83,205,0,0,0,0,0,0,0,0,0,0,0,0,0,0,800,680,680,680,680,680,680,680,680,680,680,680,680,680,680,680,680,802,0,0,0,0,
        83,83,83,205,0,0,0,0,0,0,0,0,0,0,0,0,0,0,800,680,680,680,680,680,680,680,680,680,680,680,680,680,680,680,680,802,0,0,0,0,
        83,83,83,205,0,0,0,0,0,0,0,0,0,0,0,0,0,0,800,680,680,680,680,680,680,680,680,680,680,680,680,680,680,680,680,802,0,0,0,0,
        83,83,83,205,0,0,0,0,0,0,0,0,0,0,0,0,0,0,800,680,680,680,680,680,680,680,680,680,680,680,680,680,680,680,680,802,0,0,0,0,
        83,83,83,205,0,0,0,0,0,0,0,0,0,0,0,0,0,0,800,680,680,680,680,680,680,680,680,680,680,680,680,680,680,680,680,802,0,0,0,0,
        83,83,83,205,0,0,0,0,0,0,0,0,0,0,0,0,0,0,800,680,680,680,680,680,680,680,680,680,680,680,680,680,680,680,680,802,0,0,0,0,
        83,83,83,205,0,0,0,0,0,0,0,0,0,0,0,0,0,0,800,680,680,680,680,680,6,6,6,6,6,6,6,6,6,6,6,1122,8,8,8,8,
        83,83,83,205,0,0,0,0,0,0,0,0,0,0,0,0,0,0,0,0,0,0,0,0,163,164,164,164,164,164,164,164,164,164,164,164,164,164,164,164,
        83,83,83,124,164,164,164,164,164,164,164,164,164,164,164,164,164,164,164,164,164,164,164,164,125,83,83,83,83,83,83,83,83,83,83,83,83,83,83,83,
        83,83,83,83,83,83,83,83,83,83,83,83,83,83,83,83,83,83,83,83,83,83,83,83,83,83,83,83,83,83,83,83,83,83,83,83,83,83,83,83,
        83,83,83,83,83,83,83,83,83,83,83,83,83,83,83,83,83,83,83,83,83,83,83,83,83,83,83,83,83,83,83,83,83,83,83,83,83,83,83,83],
    "name": "You Chose... Poorly"
 }