{
    "tiles": [
        95,95,95,95,95,95,95,95,95,95,95,95,95,95,95,95,95,95,95,95,95,95,95,95,95,95,95,95,95,95,95,95,95,95,95,95,95,95,95,95,
        95,95,95,95,95,95,95,95,95,95,95,95,95,95,95,95,95,95,95,95,95,95,95,95,95,95,95,95,95,95,95,95,95,95,95,95,95,95,95,95,
        95,95,95,95,95,95,95,95,95,95,95,95,95,95,95,96,256,256,256,256,256,256,256,256,256,256,256,256,256,256,256,256,256,256,256,256,256,256,256,256,
        95,95,95,95,95,95,95,95,95,95,95,95,95,95,95,217,9,9,9,9,9,9,9,9,9,9,9,9,9,9,0,0,0,0,0,0,0,0,0,0,
        95,95,95,95,95,95,95,95,95,95,95,95,95,95,95,217,0,0,0,0,0,0,0,0,0,0,0,0,0,0,0,0,0,0,0,0,0,0,0,0,
        95,95,95,95,95,95,95,95,95,95,95,95,95,95,95,217,0,0,0,0,0,0,0,0,0,0,0,0,0,0,0,0,0,0,0,0,0,0,0,0,
        95,95,95,95,95,95,95,95,95,95,95,95,95,95,95,217,0,0,0,0,0,0,0,0,0,0,0,0,0,0,0,0,0,0,0,0,0,0,0,0,
        95,95,95,95,95,95,95,95,95,95,95,95,95,95,95,217,0,0,0,0,0,0,0,0,0,0,0,0,0,0,0,0,0,0,0,0,0,0,0,0,
        95,95,95,95,95,95,95,95,95,95,95,95,95,95,95,217,0,0,0,0,0,0,0,0,0,0,0,0,0,0,0,0,0,0,0,0,0,0,0,0,
        95,95,95,95,95,95,95,95,95,95,95,95,95,95,95,217,0,0,0,0,0,0,0,0,0,0,0,0,0,0,0,0,0,0,0,0,0,0,0,0,
        95,95,95,95,95,95,95,95,95,95,95,95,95,95,95,217,0,0,0,0,0,0,0,0,0,0,0,0,0,0,0,0,0,0,0,0,0,0,0,0,
        95,95,95,95,95,95,95,95,95,95,95,95,95,95,95,217,0,0,0,0,0,0,0,0,0,0,0,0,0,0,0,0,0,0,0,0,0,0,0,0,
        95,95,95,95,95,95,95,95,95,95,95,95,95,95,95,217,0,0,0,0,0,0,0,0,0,0,0,0,0,0,0,0,0,0,0,0,0,0,0,0,
        95,95,95,95,95,95,95,95,95,95,95,95,95,95,95,217,0,0,0,0,0,0,0,0,0,0,0,0,0,0,0,0,0,0,0,0,0,0,0,0,
        95,95,95,95,95,95,95,95,95,95,95,95,95,95,95,217,0,0,0,0,0,0,0,0,0,0,0,0,0,0,0,0,0,0,0,0,0,0,0,0,
        95,95,95,95,95,95,95,95,95,95,95,95,95,95,95,217,0,0,0,0,0,0,0,0,0,0,0,0,0,0,0,0,0,0,0,0,0,0,0,0,
        95,95,95,95,95,95,95,95,95,95,95,95,95,95,95,217,0,0,0,0,0,0,0,0,0,0,0,0,0,0,0,0,0,0,0,0,0,0,0,0,
        95,95,95,95,95,95,95,95,95,95,95,95,95,95,95,217,0,0,0,0,0,0,0,0,0,0,0,0,0,0,0,0,0,0,0,0,0,0,0,0,
        95,95,95,95,95,95,95,95,95,95,95,95,95,95,95,217,0,0,0,0,0,0,0,0,8,8,8,8,8,8,8,8,8,8,8,8,8,8,8,8,
        95,95,95,95,95,95,95,95,95,95,95,95,95,95,95,217,0,0,0,0,0,0,0,0,175,176,176,176,176,176,176,176,176,176,176,176,176,176,176,176,
        95,95,95,95,95,95,95,95,95,95,95,95,95,95,95,217,0,0,0,0,0,0,0,0,215,95,95,95,95,95,95,95,95,95,95,95,95,95,95,95,
        95,95,95,95,95,95,95,95,95,95,95,95,95,95,95,217,0,0,0,0,0,0,0,0,215,95,95,95,95,95,95,95,95,95,95,95,95,95,95,95,
        95,95,95,95,95,95,95,95,95,95,95,95,95,95,95,217,0,0,0,0,0,0,0,0,215,95,95,95,95,95,95,95,95,95,95,95,95,95,95,95,
        95,95,95,95,95,95,95,95,95,95,95,95,95,95,95,217,0,0,769,770,770,770,770,770,215,95,95,95,95,95,95,95,95,95,95,95,95,95,95,95,
        95,95,95,95,95,95,95,95,95,95,95,95,95,95,95,217,0,0,809,689,689,689,689,689,215,95,95,95,95,95,95,95,95,95,95,95,95,95,95,95,
        95,95,95,95,95,95,95,95,95,95,95,95,95,95,95,217,0,0,809,689,689,689,689,689,215,95,95,95,95,95,95,95,95,95,95,95,95,95,95,95,
        95,95,95,95,95,95,95,95,95,95,95,95,95,95,95,217,0,0,809,689,689,689,689,689,215,95,95,95,95,95,95,95,95,95,95,95,95,95,95,95,
        95,95,95,95,95,95,95,95,95,95,95,95,95,95,95,217,0,0,809,689,689,689,689,689,215,95,95,95,95,95,95,95,95,95,95,95,95,95,95,95,
        95,95,95,95,95,95,95,95,95,95,95,95,95,95,95,217,0,0,809,689,689,689,689,689,215,95,95,95,95,95,95,95,95,95,95,95,95,95,95,95,
        95,95,95,95,95,95,95,95,95,95,95,95,95,95,95,217,0,0,809,689,689,689,689,689,215,95,95,95,95,95,95,95,95,95,95,95,95,95,95,95],
    "name": "Boo! Think Fast!"
 }