{
    "tiles": [
        289,289,289,289,289,289,289,289,289,289,289,289,289,289,289,289,289,289,289,289,289,289,289,289,289,289,289,289,289,289,289,289,289,289,289,289,289,289,289,289,
        450,450,450,450,291,289,289,289,290,450,450,450,450,450,450,450,450,450,291,289,289,290,450,450,450,450,450,450,450,450,450,291,289,289,289,290,450,450,450,450,
        9,9,9,9,409,289,289,289,411,7,7,7,7,7,7,7,7,7,409,289,289,411,7,7,7,7,7,7,7,7,7,409,289,289,289,411,9,9,9,9,
        0,0,0,0,449,450,450,450,451,680,680,680,680,680,680,680,680,680,409,289,289,411,680,680,680,680,680,680,680,680,680,449,450,450,450,451,0,0,0,0,
        0,0,0,0,0,0,800,680,680,680,680,680,680,680,680,680,680,680,409,289,289,411,680,680,680,680,680,680,680,680,680,680,680,802,0,0,0,0,0,0,
        0,0,0,0,0,0,800,680,680,680,680,680,680,680,680,680,680,680,449,450,450,451,680,680,680,680,680,680,680,680,680,680,680,802,0,0,0,0,0,0,
        0,0,0,0,0,0,800,680,680,680,680,680,680,680,680,680,680,680,7,7,7,7,680,680,680,680,680,680,680,680,680,680,680,802,0,0,0,0,0,0,
        0,0,0,0,0,0,800,680,680,680,680,680,680,680,680,680,680,680,680,680,680,680,680,680,680,680,680,680,680,680,680,680,680,802,0,0,0,0,0,0,
        0,0,0,0,0,0,800,680,680,680,680,680,680,680,680,680,680,680,680,680,680,680,680,680,680,680,680,680,680,680,680,680,680,802,0,0,0,0,0,0,
        0,0,0,0,0,0,800,680,680,680,680,680,680,680,680,680,680,680,680,680,680,680,680,680,680,680,680,680,680,680,680,680,680,802,0,0,0,0,0,0,
        0,0,0,0,0,0,800,680,369,370,370,371,680,680,680,680,680,680,680,680,680,680,680,680,680,680,680,680,369,370,370,371,680,802,0,0,0,0,0,0,
        0,0,0,0,0,0,800,680,409,289,289,411,680,680,680,680,680,680,680,680,680,680,680,680,680,680,680,680,409,289,289,411,680,802,0,0,0,0,0,0,
        0,0,0,0,0,0,800,680,409,289,289,411,680,680,680,680,680,680,680,680,680,680,680,680,680,680,680,680,409,289,289,411,680,802,0,0,0,0,0,0,
        0,0,0,0,0,0,0,0,409,289,289,411,680,680,680,680,680,680,680,680,680,680,680,680,680,680,680,680,409,289,289,411,0,0,0,0,0,0,0,0,
        0,0,0,0,0,0,0,0,409,289,289,411,680,680,680,680,680,680,680,680,680,680,680,680,680,680,680,680,409,289,289,411,0,0,0,0,0,0,0,0,
        0,0,0,0,0,0,800,680,409,289,289,411,680,680,680,680,680,680,680,680,680,680,680,680,680,680,680,680,409,289,289,411,680,802,0,0,0,0,0,0,
        0,0,0,0,0,0,800,680,409,289,289,411,680,680,680,680,680,680,680,680,680,680,680,680,680,680,680,680,409,289,289,411,680,802,0,0,0,0,0,0,
        0,0,0,0,0,0,800,680,449,450,450,451,680,680,680,680,680,680,680,680,680,680,680,680,680,680,680,680,449,450,450,451,680,802,0,0,0,0,0,0,
        0,0,0,0,0,0,800,680,680,680,680,680,680,680,680,680,680,680,680,680,680,680,680,680,680,680,680,680,680,680,680,680,680,802,0,0,0,0,0,0,
        0,0,0,0,0,0,800,680,680,680,680,680,680,680,680,680,680,680,680,680,680,680,680,680,680,680,680,680,680,680,680,680,680,802,0,0,0,0,0,0,
        0,0,0,0,0,0,800,680,680,680,680,680,680,680,680,680,680,680,680,680,680,680,680,680,680,680,680,680,680,680,680,680,680,802,0,0,0,0,0,0,
        0,0,0,0,0,0,800,680,680,680,680,680,680,680,680,680,6,6,6,6,6,6,6,6,680,680,680,680,680,680,680,680,680,802,0,0,0,0,0,0,
        0,0,0,0,0,0,800,680,680,680,680,680,680,680,680,680,369,370,370,370,370,370,370,371,680,680,680,680,680,680,680,680,680,802,0,0,0,0,0,0,
        0,0,0,0,0,0,800,680,680,680,680,680,680,680,680,680,409,289,289,289,289,289,289,411,680,680,680,680,680,680,680,680,680,802,0,0,0,0,0,0,
        0,0,369,370,370,370,370,370,371,680,680,680,680,680,680,680,409,289,289,289,289,289,289,411,680,680,680,680,680,680,680,369,370,370,370,370,370,371,0,0,
        8,8,409,289,289,289,289,289,411,6,6,6,6,6,6,6,409,289,289,289,289,289,289,411,6,6,6,6,6,6,6,409,289,289,289,289,289,411,8,8,
        370,370,331,289,289,289,289,289,330,370,370,370,370,370,370,370,331,289,289,289,289,289,289,330,370,370,370,370,370,370,370,331,289,289,289,289,289,330,370,370,
        289,289,289,289,289,289,289,289,289,289,289,289,289,289,289,289,289,289,289,289,289,289,289,289,289,289,289,289,289,289,289,289,289,289,289,289,289,289,289,289,
        289,289,289,289,289,289,289,289,289,289,289,289,289,289,289,289,289,289,289,289,289,289,289,289,289,289,289,289,289,289,289,289,289,289,289,289,289,289,289,289,
        289,289,289,289,289,289,289,289,289,289,289,289,289,289,289,289,289,289,289,289,289,289,289,289,289,289,289,289,289,289,289,289,289,289,289,289,289,289,289,289],
    "name": "Backsliders"
 }  