{
    "tiles": [
        107,107,107,107,107,107,107,107,229,0,0,0,0,809,689,689,227,107,107,107,107,107,107,229,689,689,811,0,0,0,0,227,107,107,107,107,107,107,107,107,
        268,268,268,268,268,268,268,268,269,0,0,0,0,809,689,689,227,107,107,107,107,107,107,229,689,689,811,0,0,0,0,267,268,268,268,268,268,268,268,268,
        9,9,9,9,9,9,9,9,9,0,0,0,0,809,689,689,227,107,107,107,107,107,107,229,689,689,811,0,0,0,0,9,9,9,9,9,9,9,9,9,
        0,0,0,0,0,0,0,0,0,0,0,0,0,809,689,689,227,107,107,107,107,107,107,229,689,689,811,0,0,0,0,0,0,0,0,0,0,0,0,0,
        0,0,0,0,0,0,0,0,0,0,0,0,0,809,689,689,227,107,107,107,107,107,107,229,689,689,811,0,0,0,0,0,0,0,0,0,0,0,0,0,
        0,0,0,0,0,0,0,0,0,0,0,0,0,809,689,689,227,107,107,107,107,107,107,229,689,689,811,0,0,0,0,0,0,0,0,0,0,0,0,0,
        0,0,0,0,0,0,0,0,0,0,0,0,0,809,689,689,227,107,107,107,107,107,107,229,689,689,811,0,0,0,0,0,0,0,0,0,0,0,0,0,
        0,0,0,0,0,0,0,0,0,0,0,0,0,809,689,689,227,107,107,107,107,107,107,229,689,689,811,0,0,0,0,0,0,0,0,0,0,0,0,0,
        0,0,0,0,0,0,0,0,0,0,0,0,0,809,689,689,227,107,107,107,107,107,107,229,689,689,811,0,0,0,0,0,0,0,0,0,0,0,0,0,
        0,0,0,0,0,0,0,0,0,0,0,0,0,809,689,689,227,107,107,107,107,107,107,229,689,689,811,0,0,0,0,0,0,0,0,0,0,0,0,0,
        0,0,0,0,0,0,0,0,0,0,0,0,0,809,689,689,227,107,107,107,107,107,107,229,689,689,811,0,0,0,0,0,0,0,0,0,0,0,0,0,
        0,0,0,0,0,0,0,0,0,0,0,0,0,809,689,689,227,107,107,107,107,107,107,229,689,689,811,0,0,0,0,0,0,0,0,0,0,0,0,0,
        0,0,0,0,0,0,0,0,0,0,0,0,0,809,689,689,227,107,107,107,107,107,107,229,689,689,811,0,0,0,0,0,0,0,0,0,0,0,0,0,
        0,0,0,0,0,0,0,0,0,0,0,0,0,0,0,0,267,268,268,268,268,268,268,269,0,0,0,0,0,0,0,0,0,0,0,0,0,0,0,0,
        0,0,0,0,0,0,0,0,0,0,0,0,0,0,0,0,0,0,0,0,0,0,0,0,0,0,0,0,0,0,0,0,0,0,0,0,0,0,0,0,
        0,0,0,0,0,0,0,0,0,0,0,0,0,809,689,689,689,689,689,689,689,689,689,689,689,689,811,0,0,0,0,0,0,0,0,0,0,0,0,0,
        0,0,0,0,0,0,0,0,0,0,0,0,0,809,689,689,689,689,689,689,689,689,689,689,689,689,811,0,0,0,0,0,0,0,0,0,0,0,0,0,
        0,0,0,0,0,0,0,0,0,0,0,0,0,809,689,689,689,689,689,689,689,689,689,689,689,689,811,0,0,0,0,0,0,0,0,0,0,0,0,0,
        0,0,0,0,0,0,0,0,0,0,0,0,0,809,689,689,689,689,689,689,689,689,689,689,689,689,811,0,0,0,0,0,0,0,0,0,0,0,0,0,
        0,0,0,0,0,0,0,0,0,0,0,0,0,809,689,689,689,689,689,689,689,689,689,689,689,689,811,0,0,0,0,0,0,0,0,0,0,0,0,0,
        0,0,0,0,0,0,0,0,0,0,0,0,0,809,689,689,689,689,689,689,689,689,689,689,689,689,811,0,0,0,0,0,0,0,0,0,0,0,0,0,
        0,0,0,0,0,0,0,0,0,0,0,0,0,849,850,850,850,850,850,850,850,850,850,850,850,850,851,0,0,0,0,0,0,0,0,0,0,0,0,0,
        0,0,0,0,0,0,0,0,0,0,0,0,0,0,0,0,0,0,0,0,0,0,0,0,0,0,0,0,0,0,0,0,0,0,0,0,0,0,0,0,
        0,0,0,0,0,0,0,0,0,0,0,0,0,0,0,0,0,0,0,0,0,0,0,0,0,0,0,0,0,0,0,0,0,0,0,0,0,0,0,0,
        0,0,0,0,0,0,0,0,0,0,0,0,0,0,0,0,0,0,0,0,0,0,0,0,0,0,0,0,0,0,0,0,0,0,0,0,0,0,0,0,
        8,8,8,8,8,8,8,8,8,8,8,8,8,8,8,8,8,8,8,8,8,8,8,8,8,8,8,8,8,8,8,8,8,8,8,8,8,8,8,8,
        188,188,188,188,188,188,188,188,188,188,188,188,188,188,188,188,188,188,188,188,188,188,188,188,188,188,188,188,188,188,188,188,188,188,188,188,188,188,188,188,
        107,107,107,107,107,107,107,107,107,107,107,107,107,107,107,107,107,107,107,107,107,107,107,107,107,107,107,107,107,107,107,107,107,107,107,107,107,107,107,107,
        107,107,107,107,107,107,107,107,107,107,107,107,107,107,107,107,107,107,107,107,107,107,107,107,107,107,107,107,107,107,107,107,107,107,107,107,107,107,107,107,
        107,107,107,107,107,107,107,107,107,107,107,107,107,107,107,107,107,107,107,107,107,107,107,107,107,107,107,107,107,107,107,107,107,107,107,107,107,107,107,107],
    "name": "Plain Sailing from Here On"
 }