{
    "tiles": [
        510,510,510,510,510,510,510,510,510,510,510,510,510,510,510,510,510,510,510,510,510,510,510,510,510,510,510,510,510,510,510,510,510,510,510,510,510,510,510,510,
        671,671,671,671,671,671,671,671,671,671,512,511,671,671,671,671,671,671,671,671,671,671,671,671,671,671,512,511,671,671,671,671,671,671,671,671,671,671,671,671,
        9,9,9,9,9,9,9,9,9,9,630,632,9,9,9,9,9,9,9,9,9,9,9,9,9,9,630,632,9,9,9,9,0,0,0,0,0,0,0,0,
        0,0,0,0,0,0,0,0,0,0,630,632,0,0,0,0,0,0,0,0,0,0,0,0,0,0,630,632,0,0,0,0,0,0,0,0,0,0,0,0,
        0,0,0,0,0,0,0,0,0,0,630,632,0,0,0,0,0,0,0,0,0,0,0,0,0,0,630,632,0,0,0,0,0,0,0,0,0,0,0,0,
        0,0,0,0,0,0,0,0,0,0,670,672,0,0,0,0,0,0,0,0,0,0,0,0,0,0,670,672,0,0,0,0,0,0,0,0,0,0,0,0,
        0,0,0,0,0,0,0,0,0,0,9,9,0,0,0,0,0,0,0,0,0,0,0,0,0,0,9,9,0,0,0,0,0,0,0,0,0,0,0,0,
        0,0,0,0,0,0,0,0,0,0,0,0,0,0,0,0,0,0,0,0,0,0,0,0,0,0,0,0,0,0,0,0,0,0,0,0,0,0,0,0,
        0,0,0,0,0,0,0,0,0,0,0,0,0,0,0,0,0,0,0,0,0,0,0,0,0,0,0,0,0,0,0,0,0,0,0,0,0,0,0,0,
        0,0,0,0,0,0,0,0,0,0,0,0,0,0,0,0,0,0,8,8,0,0,0,0,0,0,0,0,0,0,0,0,0,0,8,8,0,0,0,0,
        0,0,0,0,0,0,0,0,0,0,0,0,0,0,0,0,0,0,590,592,0,0,0,0,0,0,0,0,0,0,0,0,0,0,590,592,0,0,0,0,
        0,0,0,0,0,0,0,0,0,0,0,0,0,0,0,0,0,0,630,632,0,0,0,0,0,0,0,0,0,0,0,0,0,0,630,632,0,0,0,0,
        0,0,0,0,0,0,0,0,0,0,0,0,0,0,0,0,0,0,630,632,0,0,0,0,0,0,0,0,0,0,0,0,0,0,630,632,0,0,0,0,
        0,0,0,0,0,0,0,0,0,0,0,0,0,0,8,8,8,8,630,632,8,8,8,8,8,8,8,8,8,8,8,8,8,8,630,632,0,0,0,0,
        0,0,0,0,0,0,590,591,591,591,591,591,591,591,591,591,591,591,552,551,591,591,591,591,591,591,591,591,591,591,591,591,591,591,552,632,0,0,0,0,
        0,0,0,0,0,0,630,510,511,671,671,671,671,671,671,671,671,671,671,671,671,671,671,671,671,671,671,671,671,671,671,512,510,510,510,632,0,0,0,0,
        0,0,0,0,0,0,630,510,632,0,0,0,0,0,0,0,0,9,9,9,9,9,9,0,0,0,0,0,0,0,0,630,510,510,510,632,0,0,0,0,
        0,0,0,0,0,0,630,510,632,0,0,0,0,0,0,0,0,0,0,0,0,0,0,0,0,0,0,0,0,0,0,630,510,510,510,632,0,0,0,0,
        0,0,0,0,0,0,630,510,632,0,0,0,0,0,0,0,0,0,0,0,0,0,0,0,0,0,0,0,0,0,0,630,510,510,510,632,0,0,0,0,
        0,0,0,0,0,0,630,510,632,0,0,0,0,778,779,779,779,779,779,779,779,779,779,779,779,779,780,0,0,0,0,630,510,510,510,632,0,0,0,0,
        0,0,0,0,0,0,630,510,632,0,0,0,0,818,698,698,698,698,698,698,698,698,698,698,698,698,820,0,0,0,0,630,510,510,510,632,8,8,8,8,
        0,0,0,0,0,0,630,510,632,0,0,0,0,818,698,698,698,698,698,698,698,698,698,698,698,698,820,0,0,0,0,630,510,510,510,551,591,591,591,591,
        0,0,0,0,0,0,630,510,632,0,0,0,0,818,698,698,698,698,698,698,698,698,698,698,698,698,820,0,0,0,0,630,510,510,510,510,510,510,510,510,
        0,0,0,0,590,591,552,510,632,0,0,0,0,818,698,698,0,0,0,0,0,0,0,0,698,698,820,0,0,0,0,630,510,510,510,510,510,510,510,510,
        0,0,0,0,630,510,510,510,632,0,0,0,0,818,698,698,590,591,591,591,591,591,591,592,698,698,820,0,0,0,0,630,510,510,510,510,510,510,510,510,
        8,8,8,8,630,510,510,510,632,0,0,0,0,818,698,698,630,510,510,510,510,510,510,632,698,698,820,0,0,0,0,630,510,510,510,510,510,510,510,510,
        591,591,591,591,552,510,510,510,632,0,0,0,0,818,698,698,630,510,510,510,510,510,510,632,698,698,820,0,0,0,0,630,510,510,510,510,510,510,510,510,
        510,510,510,510,510,510,510,510,632,0,0,0,0,818,698,698,630,510,510,510,510,510,510,632,698,698,820,0,0,0,0,630,510,510,510,510,510,510,510,510,
        510,510,510,510,510,510,510,510,632,0,0,0,0,818,698,698,630,510,510,510,510,510,510,632,698,698,820,0,0,0,0,630,510,510,510,510,510,510,510,510,
        510,510,510,510,510,510,510,510,632,0,0,0,0,818,698,698,630,510,510,510,510,510,510,632,698,698,820,0,0,0,0,630,510,510,510,510,510,510,510,510],
    "name": "Gordian Knot"
 } 