{
    "tiles": [
        507,507,507,507,507,507,507,507,507,507,507,507,507,507,507,629,0,0,0,0,0,0,627,507,507,507,507,507,507,507,507,507,507,507,507,507,507,507,507,507,
        507,507,507,507,507,507,507,507,507,507,507,507,507,507,507,629,0,0,0,0,0,0,627,507,507,507,507,507,507,507,507,507,507,507,507,507,507,507,507,507,
        507,507,507,507,507,507,507,507,507,507,507,507,507,507,507,629,0,0,0,0,0,0,667,668,509,507,507,507,507,508,668,668,668,668,668,668,668,668,668,668,
        507,507,507,507,507,507,507,507,507,507,507,507,507,507,507,629,0,0,0,0,0,0,9,9,627,507,507,507,507,629,9,9,9,9,9,9,9,9,9,9,
        507,507,507,507,507,507,507,507,507,507,507,507,507,507,507,629,0,0,0,0,0,0,0,0,667,668,668,668,668,669,0,0,0,0,0,0,0,0,0,0,
        668,668,668,668,668,668,668,668,509,507,507,507,507,507,507,629,0,0,0,0,0,0,0,0,0,0,0,0,0,0,0,0,0,0,0,0,0,0,0,0,
        0,0,0,0,0,0,0,0,627,507,507,507,507,507,507,629,0,0,0,0,0,0,0,0,0,0,0,0,0,0,0,0,0,0,0,0,0,0,0,0,
        0,0,0,0,0,0,0,0,627,507,507,507,507,507,507,629,0,0,0,0,0,0,0,0,0,0,0,0,0,0,0,0,0,0,0,0,0,0,0,0,
        0,0,0,0,0,0,0,0,627,507,507,507,507,507,507,629,0,0,0,0,0,0,0,0,0,0,0,0,0,0,0,0,0,0,0,0,0,0,0,0,
        0,0,0,0,0,0,0,0,627,507,507,507,507,507,507,629,0,0,0,0,0,0,0,0,0,0,0,0,0,0,0,0,0,0,0,0,0,0,0,0,
        588,588,589,0,0,769,770,770,627,507,507,507,507,507,507,629,770,770,771,0,0,0,0,0,0,0,0,0,0,0,0,0,0,0,0,0,0,0,0,0,
        507,507,629,0,0,809,689,689,627,507,507,507,507,507,507,629,689,689,811,0,0,0,0,0,0,0,0,0,0,0,0,0,0,0,0,0,0,0,0,0,
        507,507,629,0,0,809,689,689,627,507,507,507,507,507,507,629,689,689,811,0,0,0,0,0,0,0,0,0,0,0,0,0,0,0,0,0,0,0,0,0,
        507,507,629,0,0,809,689,689,627,507,507,507,507,507,507,629,689,689,811,0,0,0,0,0,0,0,0,0,0,0,0,0,0,0,0,0,0,0,0,0,
        507,507,629,0,0,809,689,689,627,507,507,507,507,507,507,548,588,588,588,588,589,0,0,0,0,0,0,0,0,0,0,0,0,587,588,588,588,588,588,588,
        507,507,629,0,0,809,689,689,627,507,507,507,507,507,507,507,507,507,507,507,629,0,0,0,0,0,0,0,0,0,0,0,0,627,507,507,507,507,507,507,
        507,507,629,0,0,809,689,689,627,507,507,507,507,507,507,507,507,507,507,507,629,0,0,0,0,0,0,0,0,0,0,0,0,627,507,507,507,507,507,507,
        507,507,629,0,0,809,689,689,627,507,507,507,507,507,507,507,507,507,507,507,629,8,8,8,8,8,8,8,8,8,8,8,8,627,507,507,507,507,507,507,
        507,507,629,0,0,809,689,689,627,507,507,507,507,507,507,507,507,507,507,507,548,588,588,588,588,588,588,588,588,588,588,588,588,549,507,507,507,507,507,507,
        507,507,629,0,0,809,689,689,627,507,507,507,507,507,507,507,507,507,507,507,507,507,507,507,507,507,507,507,507,507,507,507,507,507,507,507,507,507,507,507,
        507,507,629,0,0,809,689,689,667,668,668,668,668,668,668,668,668,668,668,668,668,668,668,668,668,668,668,668,668,668,668,668,668,668,668,668,668,668,668,668,
        507,507,629,0,0,809,689,689,0,0,0,0,0,0,0,0,0,0,0,0,0,0,0,0,0,0,0,0,0,0,0,0,0,0,0,0,0,0,0,0,
        507,507,629,0,0,809,689,689,689,689,689,689,689,689,689,689,689,689,811,0,0,0,0,0,0,0,0,0,0,0,0,0,0,0,0,0,0,0,0,0,
        507,507,629,0,0,809,689,689,689,689,689,689,689,689,689,689,689,689,811,0,0,0,0,0,0,0,0,0,0,0,0,0,0,0,0,0,0,0,0,0,
        507,507,629,0,0,849,850,850,850,850,850,850,850,850,850,850,850,850,851,0,0,0,0,0,0,0,0,0,0,0,0,0,0,0,0,0,0,0,0,0,
        507,507,629,0,0,0,0,0,0,0,0,0,0,0,0,0,0,0,0,0,0,0,0,0,0,0,0,0,0,0,0,0,0,0,0,0,0,0,0,0,
        507,507,548,588,588,588,588,588,588,588,588,588,588,588,588,588,588,588,588,588,588,588,588,588,588,588,588,588,588,588,588,588,588,588,588,588,588,588,588,588,
        507,507,507,507,507,507,507,507,507,507,507,507,507,507,507,507,507,507,507,507,507,507,507,507,507,507,507,507,507,507,507,507,507,507,507,507,507,507,507,507,
        507,507,507,507,507,507,507,507,507,507,507,507,507,507,507,507,507,507,507,507,507,507,507,507,507,507,507,507,507,507,507,507,507,507,507,507,507,507,507,507,
        507,507,507,507,507,507,507,507,507,507,507,507,507,507,507,507,507,507,507,507,507,507,507,507,507,507,507,507,507,507,507,507,507,507,507,507,507,507,507,507],
    "name": "The Sensible Room"
 }