{
    "tiles": [
        86,86,86,86,86,86,86,86,86,86,86,86,86,86,86,86,86,86,86,86,86,86,86,86,86,86,86,86,86,86,86,86,86,86,86,86,86,86,86,86,
        86,86,86,86,86,86,86,86,86,86,86,86,86,86,86,86,86,86,87,247,247,247,247,247,247,247,247,247,247,247,247,247,247,247,247,247,247,247,247,247,
        247,247,247,247,247,88,86,86,86,86,86,86,86,86,86,86,86,86,208,0,0,0,0,0,0,0,0,0,0,0,0,0,0,0,0,0,0,0,0,0,
        0,0,0,818,698,246,247,247,247,88,86,86,86,86,86,86,86,86,208,698,698,698,698,698,698,698,698,698,698,698,698,698,820,0,0,0,0,0,0,0,
        0,0,0,818,698,820,0,818,698,246,247,247,247,88,86,86,86,86,208,698,698,698,698,698,698,698,698,698,698,698,698,698,820,0,0,0,0,0,0,0,
        0,0,0,818,698,820,0,818,699,859,859,859,859,246,247,88,86,86,208,698,698,698,698,698,698,698,698,698,698,698,698,698,820,0,0,0,0,0,0,0,
        0,0,0,818,698,820,0,818,820,0,0,0,0,0,0,246,88,86,208,698,698,698,698,698,698,698,698,698,698,698,698,698,820,0,0,0,0,0,0,0,
        0,0,0,818,698,820,0,818,820,0,778,779,779,779,779,779,206,86,208,698,698,698,698,698,0,0,0,0,0,0,0,0,0,0,0,0,0,0,0,0,
        0,0,0,818,698,820,0,818,820,0,818,699,859,859,859,859,206,86,208,698,698,698,698,166,167,167,167,167,167,167,167,167,167,167,167,167,167,167,167,167,
        0,0,0,818,698,820,0,818,820,0,818,820,0,0,0,0,206,86,208,698,698,698,698,206,86,86,86,86,86,86,86,86,86,86,86,86,86,86,86,86,
        0,0,0,818,698,820,0,818,820,0,818,820,0,778,780,0,206,86,208,698,698,698,698,206,86,86,86,86,86,87,247,247,247,247,247,247,247,247,247,247,
        0,0,0,818,698,820,0,818,820,0,818,820,0,858,860,0,206,86,208,698,698,698,698,206,86,86,86,86,86,208,0,0,0,0,0,0,0,0,0,0,
        0,0,0,818,698,820,0,818,820,0,818,820,0,0,0,0,206,86,208,698,698,698,698,206,86,86,86,86,86,208,698,698,820,0,0,0,0,0,0,0,
        0,0,0,818,698,820,0,818,820,0,818,739,779,779,779,779,206,86,208,698,698,698,698,206,86,86,86,86,86,208,698,698,820,0,0,0,0,0,0,0,
        0,0,0,818,698,820,0,818,820,0,858,859,859,859,859,166,128,86,208,698,698,698,698,206,86,86,86,86,86,208,698,698,820,0,0,0,0,0,0,0,
        0,0,0,818,698,820,0,818,820,0,0,0,0,166,167,128,86,86,208,698,698,698,698,206,86,86,86,86,86,208,698,698,820,0,0,0,0,0,0,0,
        0,0,0,818,698,820,0,818,698,166,167,167,167,128,86,86,86,86,208,698,698,698,698,206,86,86,86,86,86,208,698,698,820,0,0,0,0,0,0,0,
        0,0,0,818,698,166,167,167,167,128,86,86,86,86,86,86,86,86,208,698,698,698,698,206,86,86,86,86,86,208,698,698,820,0,0,166,167,167,167,167,
        0,0,0,818,698,206,86,87,247,247,247,247,247,247,247,247,247,247,248,698,698,698,698,206,86,86,86,86,86,208,698,698,820,0,0,206,86,86,86,86,
        0,0,0,818,698,206,86,208,0,0,0,0,0,0,0,0,0,0,0,698,698,698,698,206,86,86,86,86,86,208,698,698,820,0,0,206,86,86,86,86,
        0,0,0,858,859,206,86,208,859,859,700,698,698,698,698,698,698,698,698,698,698,698,698,206,86,86,86,86,86,208,698,698,820,0,0,206,86,86,86,86,
        0,0,0,0,0,206,86,208,0,0,818,698,698,698,698,698,698,698,698,698,698,698,698,206,86,86,86,86,86,208,698,698,820,0,0,206,86,86,86,86,
        0,0,0,0,0,206,86,208,0,0,818,698,698,698,698,698,698,698,698,698,698,698,698,206,86,86,86,86,86,208,698,698,820,0,0,206,86,86,86,86,
        0,0,0,0,0,206,86,208,0,0,818,698,698,698,698,698,698,698,698,698,698,698,698,206,86,86,86,86,86,208,698,698,820,0,0,206,86,86,86,86,
        0,0,0,0,0,206,86,208,0,0,818,698,0,0,0,0,0,0,0,0,0,0,0,206,86,86,86,86,86,208,698,698,820,0,0,206,86,86,86,86,
        0,0,0,0,0,206,86,208,0,0,818,698,166,167,167,167,167,167,167,167,167,167,167,128,86,86,86,86,86,208,698,698,820,0,0,206,86,86,86,86,
        0,0,0,0,0,206,86,208,0,0,818,698,206,86,86,86,86,86,86,86,86,86,86,86,86,86,86,86,86,208,698,698,820,0,0,206,86,86,86,86,
        0,0,0,0,0,206,86,208,0,0,818,698,206,86,86,86,86,86,86,86,86,86,86,86,86,86,86,86,86,208,698,698,820,0,0,206,86,86,86,86,
        0,0,0,0,0,206,86,208,0,0,818,698,206,86,86,86,86,86,86,86,86,86,86,86,86,86,86,86,86,208,698,698,820,0,0,206,86,86,86,86,
        0,0,0,0,0,206,86,208,0,0,818,698,206,86,86,86,86,86,86,86,86,86,86,86,86,86,86,86,86,208,698,698,820,0,0,206,86,86,86,86],
    "name": "Spikes Do!"
 }   