{
    "tiles": [
        483,483,483,483,483,483,483,483,483,483,483,483,483,483,483,483,483,483,483,483,483,483,483,483,483,483,483,483,483,483,483,483,483,483,483,483,483,483,483,483,
        644,644,644,644,644,644,644,644,644,644,644,644,485,483,483,484,644,644,644,644,644,644,644,644,644,644,644,644,644,644,644,644,644,644,644,644,485,483,483,483,
        0,0,0,0,0,0,0,0,0,0,0,0,643,644,644,645,9,9,9,9,9,9,9,9,9,9,9,9,9,9,9,9,9,9,9,9,603,483,483,483,
        0,0,0,0,0,0,0,0,0,0,0,0,0,0,0,0,0,0,0,0,0,0,0,0,0,0,0,0,0,0,0,0,0,0,0,0,603,483,483,483,
        0,0,0,0,0,0,0,0,0,0,0,0,0,0,0,0,0,0,0,0,0,0,0,0,0,0,0,0,0,0,0,0,0,0,0,0,603,483,483,483,
        0,0,0,0,0,0,0,0,775,776,777,0,0,775,776,777,0,0,775,776,777,0,0,0,0,0,0,0,0,0,0,0,0,0,0,0,603,483,483,483,
        0,0,0,0,0,0,0,0,815,695,817,0,0,815,695,817,0,0,815,695,817,0,0,0,0,0,0,0,0,0,0,0,0,0,0,0,603,483,483,483,
        0,0,0,0,0,0,0,0,815,695,817,0,0,815,695,817,0,0,815,695,817,0,0,0,0,0,0,0,0,0,0,0,0,0,0,0,603,483,483,483,
        0,0,0,0,0,0,0,0,855,856,857,0,0,855,856,857,0,0,855,856,857,0,0,0,0,0,0,0,0,0,0,0,0,0,0,0,603,483,483,483,
        0,0,0,0,0,0,0,0,0,0,0,0,0,0,0,0,0,0,0,0,0,0,0,0,0,0,0,0,0,0,0,0,0,0,0,0,603,483,483,483,
        0,0,0,0,0,0,0,0,0,0,0,0,0,0,0,0,0,0,0,0,0,0,0,0,0,0,0,0,0,0,0,0,0,0,0,0,603,483,483,483,
        0,0,0,0,0,0,0,0,775,776,777,0,0,775,776,777,0,0,775,776,777,0,0,0,0,0,0,0,0,0,0,0,0,0,0,0,603,483,483,483,
        0,0,0,0,0,0,0,0,815,695,817,0,0,815,695,817,0,0,815,695,817,0,0,0,0,0,0,0,0,0,0,0,8,8,8,8,603,483,483,483,
        0,0,0,0,0,0,0,0,815,695,817,0,0,815,695,817,0,0,815,695,817,0,0,0,0,0,0,0,0,0,0,0,563,564,564,564,525,483,483,483,
        0,0,0,0,0,0,0,0,855,856,857,0,0,855,856,857,0,0,855,856,857,0,0,0,0,0,0,0,0,0,0,0,643,644,644,644,485,483,483,483,
        0,0,0,0,0,0,0,0,0,0,0,0,0,0,0,0,0,0,0,0,0,0,0,0,0,0,0,0,0,0,0,0,0,0,0,0,603,483,483,483,
        0,0,0,0,0,0,0,0,0,0,0,0,0,0,0,0,0,0,0,0,0,0,0,0,0,0,0,0,0,0,0,0,0,0,0,0,603,483,483,483,
        0,0,0,0,0,0,0,0,775,776,777,0,0,775,776,777,0,0,775,776,777,0,0,0,0,0,0,0,0,0,0,0,0,0,0,0,603,483,483,483,
        0,0,0,0,0,0,0,0,815,695,817,0,0,815,695,817,0,0,815,695,817,0,0,0,0,0,0,0,0,0,0,0,0,0,0,0,603,483,483,483,
        0,0,0,0,0,0,0,0,815,695,817,0,0,815,695,817,0,0,815,695,817,0,0,0,0,0,0,0,0,0,0,0,0,0,0,0,603,483,483,483,
        8,8,8,0,0,0,0,0,855,856,857,0,0,855,856,857,0,0,855,856,857,0,0,0,0,8,8,8,8,8,8,8,0,0,0,0,603,483,483,483,
        564,564,565,0,0,0,0,0,0,0,0,0,0,0,0,0,0,0,0,0,0,0,0,0,0,563,564,564,564,564,564,565,0,0,0,0,603,483,483,483,
        483,483,605,0,0,0,0,0,0,0,0,0,0,0,0,0,0,0,0,0,0,0,0,0,0,603,483,484,644,644,644,645,0,0,0,0,603,483,483,483,
        483,483,605,0,0,0,0,0,0,0,0,0,0,0,0,0,0,0,0,0,0,0,0,0,0,603,483,605,0,0,0,0,0,0,0,0,603,483,483,483,
        483,483,605,0,0,0,0,0,0,0,0,0,0,0,0,0,0,0,0,0,0,0,0,0,0,603,483,605,0,0,0,0,0,0,0,0,603,483,483,483,
        483,483,605,8,8,8,8,8,8,8,8,8,8,8,8,8,8,8,8,8,8,8,8,8,8,603,483,605,0,0,0,0,0,0,0,0,603,483,483,483,
        483,483,524,564,564,564,564,564,564,564,564,564,564,564,564,564,564,564,564,564,564,564,564,564,564,525,483,605,0,0,0,0,0,0,0,0,603,483,483,483,
        483,483,483,483,483,483,483,483,483,483,483,483,483,483,483,483,483,483,483,483,483,483,483,483,483,483,483,605,0,0,0,0,0,0,0,0,603,483,483,483,
        483,483,483,483,483,483,483,483,483,483,483,483,483,483,483,483,483,483,483,483,483,483,483,483,483,483,483,605,0,0,0,0,0,0,0,0,603,483,483,483,
        483,483,483,483,483,483,483,483,483,483,483,483,483,483,483,483,483,483,483,483,483,483,483,483,483,483,483,605,0,0,0,0,0,0,0,0,603,483,483,483],
    "name": "You Just Keep Coming Back"
 }