{
    "tiles": [
        92,92,92,92,92,92,92,92,92,92,92,92,92,92,92,92,92,92,92,92,92,92,92,92,92,92,92,92,92,92,92,92,92,92,92,92,92,92,92,92,
        92,92,92,92,92,92,92,92,92,92,92,92,92,92,92,92,92,92,92,92,93,253,253,253,253,253,253,253,94,92,92,92,92,92,92,92,92,92,92,92,
        253,253,253,253,253,253,253,253,253,253,253,253,253,253,253,253,253,253,253,253,254,9,9,9,9,9,9,9,212,92,92,92,92,92,92,92,92,92,92,92,
        0,0,0,0,0,0,0,0,0,0,0,0,0,0,0,0,0,0,0,0,0,0,0,0,0,0,0,0,212,92,92,92,92,92,92,92,92,92,92,92,
        0,0,0,0,0,0,0,0,0,0,0,0,0,0,0,0,0,0,0,0,0,0,0,0,0,0,0,0,212,92,92,92,92,92,92,92,92,92,92,92,
        0,0,0,0,0,0,0,0,0,0,0,0,0,0,0,0,0,0,0,0,0,0,0,0,0,0,0,0,212,92,92,92,92,92,92,92,92,92,92,92,
        0,0,0,0,0,0,0,0,0,0,0,0,0,0,0,0,0,0,0,0,0,0,0,0,0,0,0,0,212,92,92,92,92,92,92,92,92,92,92,92,
        0,0,0,0,0,0,0,0,0,0,0,0,0,0,0,0,0,0,0,0,0,0,0,0,0,0,0,0,212,92,92,92,92,92,92,92,92,92,92,92,
        0,0,0,0,0,0,0,0,0,0,0,0,0,172,173,174,0,0,0,0,0,0,0,0,0,0,0,0,212,92,92,92,92,92,92,92,92,92,92,92,
        0,0,0,0,0,0,0,0,0,0,0,0,0,212,92,214,0,0,0,0,0,0,0,0,0,0,0,0,212,92,92,92,92,92,92,92,92,92,92,92,
        0,0,0,0,0,0,0,0,0,0,0,0,0,212,92,214,0,0,0,0,0,0,0,0,0,0,0,0,212,92,92,92,92,92,92,92,92,92,92,92,
        0,0,0,0,0,0,0,0,0,0,0,0,0,212,92,214,0,0,0,0,0,0,0,0,0,0,0,0,212,92,92,92,92,92,92,92,92,92,92,92,
        0,0,0,0,0,0,0,0,0,0,0,0,0,212,92,214,0,0,0,0,0,0,0,0,0,0,0,0,212,92,92,92,92,92,92,92,92,92,92,92,
        0,0,0,0,0,0,0,0,0,0,0,0,0,212,92,214,0,0,0,0,0,0,0,0,0,0,0,0,212,92,92,92,92,92,92,92,92,92,92,92,
        0,0,0,0,0,0,0,0,0,0,0,0,0,212,92,214,0,0,0,0,0,0,0,0,0,0,0,0,212,92,92,92,92,92,92,92,92,92,92,92,
        0,0,0,0,0,0,0,0,0,0,0,0,0,212,92,214,0,0,0,0,0,0,0,0,0,0,0,0,212,92,92,92,92,92,92,92,92,92,92,92,
        0,0,0,0,0,0,0,0,0,0,0,0,0,212,92,214,0,0,0,0,0,0,0,0,0,0,0,0,212,92,92,92,92,92,92,92,92,92,92,92,
        0,0,0,0,0,0,0,0,0,0,0,0,0,212,92,214,8,8,8,8,0,0,0,0,8,8,8,8,212,92,92,92,92,92,92,92,92,92,92,92,
        8,8,8,8,8,8,8,8,8,8,8,8,8,212,92,133,173,173,173,174,0,0,0,0,172,173,173,173,134,92,92,92,92,92,92,92,92,92,92,92,
        173,173,173,173,173,173,173,173,173,173,173,173,173,134,92,92,92,92,92,214,0,0,0,0,212,92,92,92,92,92,92,92,92,92,92,92,92,92,92,92,
        92,92,92,92,92,92,92,92,92,92,92,92,92,92,92,92,92,92,92,214,0,0,0,0,212,92,92,92,92,92,92,92,92,92,92,92,92,92,92,92,
        92,92,92,92,92,92,92,92,92,92,92,92,92,92,92,93,253,253,253,254,0,0,0,0,212,92,92,92,92,92,92,92,92,92,92,92,92,92,92,92,
        92,92,92,92,92,92,92,92,92,92,92,92,92,92,92,214,0,0,0,0,0,0,0,0,212,92,92,92,92,92,92,92,92,92,92,92,92,92,92,92,
        92,92,92,92,92,92,92,92,92,92,92,92,92,92,92,214,0,0,0,0,0,0,0,0,212,92,92,92,92,92,92,92,92,92,92,92,92,92,92,92,
        92,92,92,92,92,92,92,92,92,92,92,92,92,92,92,214,0,0,0,0,0,0,0,0,212,92,92,92,92,92,92,92,92,92,92,92,92,92,92,92,
        92,92,92,92,92,92,92,92,92,92,92,92,92,92,92,214,0,0,0,0,0,0,0,0,212,92,92,92,92,92,92,92,92,92,92,92,92,92,92,92,
        92,92,92,92,92,92,92,92,92,92,92,92,92,92,92,214,0,0,0,0,0,0,0,0,212,92,92,92,92,92,92,92,92,92,92,92,92,92,92,92,
        92,92,92,92,92,92,92,92,92,92,92,92,92,92,92,214,0,0,0,0,0,0,172,173,134,92,92,92,92,92,92,92,92,92,92,92,92,92,92,92,
        92,92,92,92,92,92,92,92,92,92,92,92,92,92,92,214,0,0,0,0,0,0,212,92,92,92,92,92,92,92,92,92,92,92,92,92,92,92,92,92,
        92,92,92,92,92,92,92,92,92,92,92,92,92,92,92,214,0,0,0,0,0,0,212,92,92,92,92,92,92,92,92,92,92,92,92,92,92,92,92,92],
    "name": "Quicksand"
 }    