{
    "tiles": [
        92,92,92,92,92,92,92,92,92,92,92,92,92,92,92,92,92,92,92,92,92,92,92,92,92,92,92,214,0,0,0,0,0,0,0,0,212,92,92,92,
        253,253,253,253,253,253,253,253,253,253,253,253,253,253,253,253,253,253,253,253,253,253,253,253,253,253,253,254,0,0,0,0,0,0,0,0,212,92,92,92,
        9,9,9,9,9,9,9,9,9,9,9,9,9,9,9,9,9,9,9,9,9,9,9,9,9,9,9,9,0,0,0,0,0,0,0,0,212,92,92,92,
        0,0,0,0,0,0,0,0,0,0,0,0,0,0,0,0,0,0,0,0,0,0,0,0,0,0,0,0,0,0,0,0,0,0,0,0,212,92,92,92,
        0,0,0,0,0,0,0,0,0,0,0,0,0,0,0,0,0,0,0,0,0,0,0,0,0,0,0,0,0,0,0,0,0,0,0,0,212,92,92,92,
        0,0,0,0,0,0,0,0,0,0,0,0,0,0,0,0,0,0,0,0,0,0,0,0,0,0,0,0,763,764,764,764,764,764,764,764,212,92,92,92,
        0,0,0,0,0,0,0,0,0,0,0,0,0,0,0,0,0,0,0,0,0,0,0,0,0,0,0,0,803,683,683,683,683,683,683,683,212,92,92,92,
        0,0,0,0,0,0,0,0,0,0,0,0,0,0,0,0,0,0,0,0,0,0,0,0,0,0,0,0,803,683,683,683,683,683,683,683,212,92,92,92,
        0,0,0,0,0,0,0,0,0,0,0,0,0,0,0,0,0,0,0,0,0,0,0,0,0,0,0,0,803,683,683,683,683,683,683,683,212,92,92,92,
        0,0,0,0,0,0,0,0,0,0,0,0,0,0,0,0,0,0,0,0,0,0,0,0,0,0,0,0,803,683,683,683,683,683,683,683,212,92,92,92,
        0,0,0,0,0,0,0,0,0,0,0,0,0,0,0,0,0,0,0,0,0,0,0,0,0,0,0,0,803,683,683,683,683,683,683,683,212,92,92,92,
        0,0,0,0,0,0,0,0,0,0,0,0,0,0,0,0,0,0,0,0,0,0,0,0,0,0,172,173,173,173,173,174,683,683,683,683,212,92,92,92,
        0,0,0,0,0,0,0,0,0,0,0,0,0,0,0,0,0,0,0,0,0,0,0,0,0,0,212,92,92,92,92,214,683,683,683,683,212,92,92,92,
        0,0,0,0,0,0,0,0,0,0,0,0,0,0,0,0,0,0,0,0,0,0,0,0,0,0,212,92,92,92,92,214,683,683,683,683,212,92,92,92,
        0,0,0,0,0,0,0,0,0,0,0,0,0,0,0,0,0,0,0,0,0,0,0,0,0,0,212,92,92,92,92,214,683,683,683,683,212,92,92,92,
        0,0,0,0,0,0,0,0,0,0,0,0,0,0,0,0,0,0,0,0,0,0,0,0,0,0,212,92,92,92,92,214,683,683,683,683,212,92,92,92,
        0,0,0,0,0,0,0,0,0,0,0,0,0,0,0,0,0,0,0,0,0,0,0,0,0,0,212,92,92,92,92,214,683,683,683,683,212,92,92,92,
        0,0,0,0,0,0,0,0,0,0,0,0,0,0,0,0,0,0,0,0,0,0,0,0,0,0,252,253,253,253,253,254,683,683,683,683,212,92,92,92,
        0,0,0,0,0,0,0,0,0,0,0,0,0,0,0,0,0,0,0,0,0,0,0,0,0,0,0,0,803,683,683,683,683,683,683,683,212,92,92,92,
        0,0,0,0,0,0,0,0,0,0,0,0,0,0,0,0,0,0,0,0,0,0,0,0,0,0,0,0,803,683,683,683,683,683,683,683,212,92,92,92,
        0,0,0,0,0,0,0,0,0,0,0,0,0,0,0,0,0,8,8,8,8,8,8,8,0,0,0,0,843,844,844,844,844,844,844,844,212,92,92,92,
        0,0,0,0,0,0,0,0,0,0,0,0,0,0,0,0,0,172,173,173,173,173,173,174,0,0,0,0,0,0,0,0,0,0,0,0,212,92,92,92,
        0,0,0,0,0,0,0,0,0,0,0,0,0,0,0,0,0,212,92,92,92,92,92,214,8,8,8,8,8,8,8,8,8,8,8,8,212,92,92,92,
        0,0,0,0,0,0,0,0,0,0,0,0,0,0,0,0,0,212,92,92,92,92,92,133,173,173,173,173,173,173,173,173,173,173,173,173,134,92,92,92,
        0,0,0,0,0,0,0,0,0,0,0,0,0,0,0,0,0,212,92,92,92,92,92,92,92,92,92,92,92,92,92,92,92,92,92,92,92,92,92,92,
        8,8,8,8,8,8,8,8,8,8,8,8,8,8,8,8,8,212,92,92,92,92,92,92,92,92,92,92,92,92,92,92,92,92,92,92,92,92,92,92,
        173,173,173,173,173,173,173,173,173,173,173,173,173,173,173,173,173,134,92,92,92,92,92,92,92,92,92,92,92,92,92,92,92,92,92,92,92,92,92,92,
        92,92,92,92,92,92,92,92,92,92,92,92,92,92,92,92,92,92,92,92,92,92,92,92,92,92,92,92,92,92,92,92,92,92,92,92,92,92,92,92,
        92,92,92,92,92,92,92,92,92,92,92,92,92,92,92,92,92,92,92,92,92,92,92,92,92,92,92,92,92,92,92,92,92,92,92,92,92,92,92,92,
        92,92,92,92,92,92,92,92,92,92,92,92,92,92,92,92,92,92,92,92,92,92,92,92,92,92,92,92,92,92,92,92,92,92,92,92,92,92,92,92],
    "name": "Ha Ha Ha Not Really"
 }