{
    "tiles": [
        0,0,0,0,0,433,313,435,0,0,809,689,473,474,474,474,474,474,474,315,313,313,313,313,313,313,313,313,313,435,689,689,811,0,0,433,313,313,313,313,
        0,0,0,0,0,433,313,435,0,0,809,689,689,689,689,689,689,689,689,433,313,313,313,313,313,313,313,313,313,435,689,689,811,0,0,433,313,313,313,313,
        0,0,0,0,0,433,313,435,0,0,809,689,689,689,689,689,689,689,689,473,474,474,474,474,474,474,474,315,313,435,689,689,811,0,0,433,313,313,313,313,
        0,0,0,0,0,433,313,435,0,0,809,689,689,689,689,689,689,689,689,0,0,0,0,0,0,0,0,433,313,435,689,689,811,0,0,433,313,313,313,313,
        0,0,0,0,0,433,313,435,0,0,809,689,689,689,689,689,689,689,689,689,689,689,689,689,689,689,689,433,313,435,689,689,811,0,0,433,313,313,313,313,
        0,0,0,0,0,433,313,435,0,0,809,689,689,689,689,689,689,689,689,689,689,689,689,689,689,689,689,433,313,435,689,689,811,0,0,433,313,313,313,313,
        394,394,394,394,394,355,313,435,0,0,809,689,689,689,689,689,689,689,689,689,689,689,689,689,689,689,689,433,313,435,689,689,811,0,0,433,313,313,313,313,
        474,474,474,474,474,315,313,435,0,0,809,689,689,689,689,689,689,689,689,689,689,689,689,689,689,689,689,433,313,435,689,689,811,0,0,433,313,313,313,313,
        0,0,0,0,0,433,313,435,0,0,0,0,0,0,0,0,689,689,689,0,0,0,0,689,689,689,689,433,313,435,689,689,811,0,0,433,313,313,313,313,
        0,0,0,0,0,433,313,354,394,394,394,394,394,394,394,395,689,689,689,393,394,394,395,689,689,689,689,433,313,435,689,689,811,0,0,433,313,313,313,313,
        0,0,0,0,0,433,313,314,474,474,474,474,474,474,474,475,689,689,689,473,474,474,475,689,689,689,689,433,313,435,689,689,811,0,0,433,313,313,313,313,
        0,0,0,0,0,433,313,435,0,0,0,0,0,0,0,0,689,689,689,0,0,0,0,689,689,689,689,433,313,435,689,689,811,0,0,433,313,313,313,313,
        0,0,0,0,0,433,313,435,0,0,809,689,689,689,689,689,689,689,689,689,689,689,689,689,689,689,689,433,313,435,689,689,811,0,0,433,313,313,313,313,
        0,0,0,0,0,433,313,435,0,0,809,689,689,689,689,689,689,689,689,689,689,689,689,689,689,689,689,433,313,435,689,689,811,0,0,433,313,313,313,313,
        0,0,0,0,0,433,313,435,0,0,809,689,689,689,689,689,689,689,689,689,689,689,689,689,689,689,689,433,313,435,689,689,811,0,0,433,313,313,313,313,
        0,0,0,0,0,433,313,435,0,0,809,689,689,689,689,689,689,689,689,689,689,689,689,689,689,689,689,433,313,435,689,689,811,0,0,433,313,313,313,313,
        0,0,0,0,0,433,313,435,0,0,809,689,689,689,689,689,689,689,689,689,689,689,689,689,689,689,689,433,313,435,689,689,811,0,0,433,313,313,313,313,
        0,0,0,0,0,433,313,435,0,0,809,689,0,0,0,0,0,689,689,689,0,0,0,0,0,0,0,433,313,435,689,689,811,0,0,433,313,313,313,313,
        0,0,0,0,0,433,313,435,0,0,809,689,393,394,394,394,395,689,689,689,393,394,394,394,394,394,394,355,313,435,689,689,811,0,0,433,313,313,313,313,
        0,0,0,0,0,433,313,435,0,0,809,689,473,474,474,474,475,689,689,689,473,474,474,474,474,474,474,474,474,475,689,689,811,0,0,433,313,313,313,313,
        0,0,0,0,0,433,313,435,0,0,809,689,0,0,0,0,0,689,689,689,0,0,0,0,0,0,0,0,0,0,689,689,811,0,0,433,313,313,313,313,
        0,0,0,0,0,433,313,435,0,0,809,689,689,689,689,689,689,689,689,689,689,689,689,689,689,689,689,689,689,689,689,689,811,0,0,433,313,313,313,313,
        0,0,0,0,0,433,313,435,0,0,849,850,850,850,850,850,850,850,850,850,850,850,850,850,850,850,850,850,850,850,850,850,851,0,0,433,313,313,313,313,
        0,0,0,0,0,433,313,435,0,0,0,0,0,0,0,0,0,0,0,0,0,0,0,0,0,0,0,0,0,0,0,0,0,0,0,433,313,313,313,313,
        0,0,0,0,0,433,313,435,0,0,0,0,0,0,0,0,0,0,0,0,0,0,0,0,0,0,0,0,0,0,0,0,0,0,0,433,313,313,313,313,
        0,0,0,0,0,433,313,435,0,0,0,0,0,0,0,0,0,0,0,0,0,0,0,0,0,0,0,0,0,0,0,0,0,0,0,433,313,313,313,313,
        394,394,394,394,394,355,313,354,394,394,394,394,394,394,394,394,395,0,0,0,0,0,0,0,0,0,0,393,394,394,394,394,394,394,394,355,313,313,313,313,
        313,313,313,313,313,313,313,313,313,313,313,313,313,313,313,313,435,0,0,0,0,0,0,0,0,0,0,433,313,313,313,313,313,313,313,313,313,313,313,313,
        313,313,313,313,313,313,313,313,313,313,313,313,313,313,313,313,354,394,394,394,394,394,394,394,394,394,394,355,313,313,313,313,313,313,313,313,313,313,313,313,
        313,313,313,313,313,313,313,313,313,313,313,313,313,313,313,313,313,313,313,313,313,313,313,313,313,313,313,313,313,313,313,313,313,313,313,313,313,313,313,313],
    "name": "Parabolica"
 }   