{
    "tiles": [
        0,0,0,0,0,0,0,815,695,695,695,695,695,695,695,209,89,211,695,695,695,695,695,695,695,817,0,0,0,0,0,209,89,89,89,89,89,89,89,89,
        0,0,0,0,0,0,0,815,695,695,695,695,695,695,695,209,89,211,695,695,695,695,695,695,695,817,0,0,0,0,0,209,89,89,89,89,89,89,89,89,
        0,0,0,0,0,0,0,815,695,695,695,695,695,695,695,209,89,211,695,695,695,695,695,695,695,817,0,0,0,0,0,209,89,89,89,89,89,89,89,89,
        0,0,0,0,0,0,0,815,695,695,695,695,695,695,695,209,89,211,695,695,695,695,695,695,695,817,0,0,0,0,0,209,89,89,89,89,89,89,89,89,
        0,0,0,0,0,0,0,815,695,695,695,695,695,695,695,209,89,211,695,695,695,695,695,695,695,817,0,0,0,0,0,209,89,89,89,89,89,89,89,89,
        0,0,0,0,0,0,0,815,695,695,695,695,695,695,695,209,89,211,695,695,695,695,695,695,695,817,0,0,0,0,0,209,89,89,89,89,89,89,89,89,
        0,0,0,0,0,0,0,815,695,695,695,695,695,695,695,209,89,211,695,695,695,695,695,695,695,817,0,0,0,0,0,209,89,89,89,89,89,89,89,89,
        0,0,0,0,0,0,0,815,695,695,695,695,695,695,695,209,89,211,695,695,695,695,695,695,695,817,0,0,0,0,0,209,89,89,89,89,89,89,89,89,
        0,0,0,0,0,0,0,815,695,695,695,695,695,695,695,209,89,211,695,695,695,695,695,695,695,817,0,0,0,0,0,209,89,89,89,89,89,89,89,89,
        0,0,0,0,0,0,0,815,695,695,695,695,695,695,695,209,89,211,695,695,695,695,695,695,695,817,0,0,0,0,0,209,89,89,89,89,89,89,89,89,
        0,0,0,0,0,0,0,815,695,695,695,695,695,695,695,209,89,211,695,695,695,695,695,695,695,817,0,0,0,0,0,209,89,89,89,89,89,89,89,89,
        0,0,0,0,0,0,0,815,695,695,695,695,695,695,695,209,89,211,695,695,695,695,695,695,695,817,0,0,0,0,0,209,89,89,89,89,89,89,89,89,
        170,170,170,170,170,170,170,170,170,170,170,170,170,170,170,131,89,211,695,695,695,695,695,695,695,817,0,0,0,0,0,249,250,250,250,250,250,250,91,89,
        89,89,89,89,89,89,89,89,89,89,89,89,89,89,89,89,89,211,695,695,695,695,695,695,695,817,0,0,0,0,0,0,0,0,0,0,0,0,209,89,
        89,89,89,89,89,89,89,89,89,89,89,89,89,89,89,89,89,211,695,695,695,695,695,695,695,817,0,0,0,0,0,0,0,0,0,0,0,0,209,89,
        250,250,250,250,250,250,250,250,250,250,250,250,250,250,250,250,250,251,695,695,695,695,695,695,695,817,0,0,0,0,0,0,0,0,0,0,0,0,209,89,
        0,0,0,0,0,0,0,0,0,0,0,0,0,0,0,0,0,0,695,695,695,695,695,695,695,817,0,0,0,0,0,0,0,0,0,0,0,0,209,89,
        0,0,0,0,0,0,0,815,695,695,695,695,695,695,695,695,695,695,695,695,695,695,695,695,695,817,0,0,0,0,0,0,0,0,0,0,0,0,209,89,
        0,0,0,0,0,0,0,815,695,695,695,695,695,695,695,695,695,695,695,695,695,695,695,695,695,817,0,0,0,0,0,0,0,0,0,0,0,0,209,89,
        0,0,0,0,0,0,0,855,856,856,856,856,856,856,856,856,856,856,856,856,856,856,856,856,856,857,0,0,0,0,0,0,0,0,0,0,0,0,209,89,
        0,0,0,0,0,0,0,0,0,0,0,0,0,0,0,0,0,0,0,0,0,0,0,0,0,0,0,0,0,0,0,0,0,0,0,0,0,0,209,89,
        0,0,0,0,0,0,0,0,8,8,8,8,8,8,8,8,0,0,0,0,0,0,0,0,0,0,0,0,0,0,0,169,170,170,170,170,170,170,131,89,
        0,0,0,0,0,0,0,0,169,170,170,170,170,170,170,171,0,0,0,0,0,0,0,0,0,0,0,0,0,0,0,209,89,89,89,89,89,89,89,89,
        0,0,0,0,0,0,0,0,209,89,89,89,89,89,89,211,0,0,0,0,0,0,0,0,0,0,0,0,0,0,0,209,89,89,89,89,89,89,89,89,
        170,170,170,170,170,170,170,170,131,89,89,89,89,89,89,130,170,170,170,170,170,170,170,170,170,170,170,170,170,170,170,131,89,89,89,89,89,89,89,89,
        89,89,89,89,89,89,89,89,89,89,89,89,89,89,89,89,89,89,89,89,89,89,89,89,89,89,89,89,89,89,89,89,89,89,89,89,89,89,89,89,
        89,89,89,89,89,89,89,89,89,89,89,89,89,89,89,89,89,89,89,89,89,89,89,89,89,89,89,89,89,89,89,89,89,89,89,89,89,89,89,89,
        89,89,89,89,89,89,89,89,89,89,89,89,89,89,89,89,89,89,89,89,89,89,89,89,89,89,89,89,89,89,89,89,89,89,89,89,89,89,89,89,
        89,89,89,89,89,89,89,89,89,89,89,89,89,89,89,89,89,89,89,89,89,89,89,89,89,89,89,89,89,89,89,89,89,89,89,89,89,89,89,89,
        89,89,89,89,89,89,89,89,89,89,89,89,89,89,89,89,89,89,89,89,89,89,89,89,89,89,89,89,89,89,89,89,89,89,89,89,89,89,89,89],
    "name": "If You Fall Up"
 }