{
    "tiles": [
        86,86,86,86,86,86,86,86,86,86,86,86,86,86,86,86,86,86,86,86,86,86,86,86,86,86,86,86,86,86,86,86,86,86,86,86,86,86,86,86,
        86,86,86,86,86,86,86,86,86,86,86,86,86,86,86,86,86,86,86,86,86,86,86,86,86,86,86,86,86,86,86,86,86,86,86,86,86,86,86,86,
        247,247,247,88,86,86,86,87,247,247,247,247,247,247,247,88,86,86,86,86,86,86,86,86,87,247,247,247,247,247,247,247,88,86,86,86,87,247,247,247,
        9,9,9,206,86,86,86,208,9,9,9,9,9,9,9,206,86,86,86,86,86,86,86,86,208,9,9,9,9,9,9,9,206,86,86,86,208,9,9,9,
        0,0,0,246,247,247,247,248,0,0,0,0,0,0,0,206,86,86,86,86,86,86,86,86,208,0,0,0,0,0,0,0,246,247,247,247,248,0,0,0,
        0,0,0,0,0,0,0,0,0,0,0,0,0,0,0,246,247,247,247,247,247,247,247,247,248,0,0,0,0,0,0,0,0,0,0,0,0,0,0,0,
        0,0,0,0,0,0,0,0,0,0,0,0,0,0,0,0,0,818,698,698,698,698,820,0,0,0,0,0,0,0,0,0,0,0,0,0,0,0,0,0,
        0,0,0,0,0,0,0,0,0,0,0,0,0,0,0,0,0,818,698,698,698,698,820,0,0,0,0,0,0,0,0,0,0,0,0,0,0,0,0,0,
        0,0,0,0,0,0,0,0,0,0,0,0,0,0,0,0,0,818,698,698,698,698,820,0,0,0,0,0,0,0,0,0,0,0,0,0,0,0,0,0,
        0,0,0,0,0,0,0,0,0,0,0,0,0,0,0,0,0,818,698,698,698,698,820,0,0,0,0,0,0,0,0,0,0,0,0,0,0,0,0,0,
        0,0,0,0,0,0,0,0,0,0,0,0,0,0,0,0,0,818,698,698,698,698,820,0,0,0,0,0,0,0,0,0,0,0,0,0,0,0,0,0,
        0,0,0,0,0,0,0,0,0,0,0,0,0,0,0,0,0,858,859,859,859,859,860,0,0,0,0,0,0,0,0,0,0,0,0,0,0,0,0,0,
        0,0,0,0,0,0,0,0,0,0,0,0,0,0,0,0,0,0,0,0,0,0,0,0,0,0,0,0,0,0,0,0,0,0,0,0,0,0,0,0,
        0,0,0,0,0,0,0,0,0,0,0,0,0,0,0,0,0,0,0,0,0,0,0,0,0,0,0,0,0,0,0,0,0,0,0,0,0,0,0,0,
        167,167,167,167,167,167,167,167,167,167,167,167,167,167,167,168,0,0,0,0,0,0,0,0,166,167,167,167,167,167,167,168,0,0,0,0,0,0,0,0,
        86,86,86,86,86,86,86,86,86,87,247,247,247,88,86,208,0,0,0,0,0,0,0,0,206,86,87,247,247,247,88,127,167,168,0,0,0,0,0,0,
        86,86,86,86,86,86,86,86,86,208,0,0,0,206,86,208,0,0,0,0,0,0,0,0,206,86,208,0,0,0,206,86,86,127,167,168,0,0,0,0,
        86,86,86,86,86,86,86,86,86,208,0,0,0,206,86,208,8,8,8,8,8,8,8,8,206,86,208,0,0,0,206,86,86,86,86,127,167,168,0,0,
        86,86,86,86,86,86,86,86,86,208,0,0,0,206,86,127,167,167,167,167,167,167,167,167,128,86,208,0,0,0,206,86,86,86,86,86,86,127,167,167,
        86,86,86,86,86,86,86,86,86,208,779,779,779,206,86,86,86,86,86,86,86,86,86,86,86,86,208,779,779,779,206,86,86,86,86,86,86,86,86,86,
        247,247,247,247,247,247,247,247,247,248,698,698,698,246,247,247,247,247,247,247,247,247,247,247,247,247,248,698,698,698,246,247,247,247,247,247,247,247,247,247,
        0,0,0,0,0,0,0,0,0,0,698,698,698,0,0,0,0,0,0,0,0,0,0,0,0,0,0,698,698,698,0,0,0,0,0,0,0,0,0,0,
        0,0,0,0,0,818,698,698,698,698,698,698,698,698,698,698,698,698,698,698,698,698,698,698,698,698,698,698,698,698,698,698,698,820,0,0,0,0,0,0,
        0,0,0,0,0,858,859,859,859,859,859,859,859,859,859,859,859,859,859,859,859,859,859,859,859,859,859,859,859,859,859,859,859,860,0,0,0,0,0,0,
        0,0,0,0,0,0,0,0,0,0,0,0,0,0,0,0,0,0,0,0,0,0,0,0,0,0,0,0,0,0,0,0,0,0,0,0,0,0,0,0,
        0,0,0,0,0,0,0,0,0,0,0,0,0,0,0,0,0,0,0,0,0,0,0,0,0,0,0,0,0,0,0,0,0,0,0,0,0,0,0,0,
        167,167,167,167,167,167,167,167,167,167,167,167,167,167,167,167,167,167,167,167,167,167,167,167,167,167,167,167,167,167,167,167,167,167,167,167,167,167,167,167,
        86,86,86,86,86,86,86,86,86,86,86,86,86,86,86,86,86,86,86,86,86,86,86,86,86,86,86,86,86,86,86,86,86,86,86,86,86,86,86,86,
        86,86,86,86,86,86,86,86,86,86,86,86,86,86,86,86,86,86,86,86,86,86,86,86,86,86,86,86,86,86,86,86,86,86,86,86,86,86,86,86,
        86,86,86,86,86,86,86,86,86,86,86,86,86,86,86,86,86,86,86,86,86,86,86,86,86,86,86,86,86,86,86,86,86,86,86,86,86,86,86,86],
    "name": "The Tomb of Mad Carew"
 }