{
    "tiles": [
        0,0,0,0,0,0,0,0,0,0,0,0,0,0,0,0,0,0,0,0,0,0,0,0,0,0,0,0,0,0,0,0,0,0,0,0,0,0,0,0,
        0,0,0,0,0,0,0,0,0,0,0,0,0,0,0,0,0,0,0,0,0,0,0,0,0,0,0,0,0,0,0,0,0,0,0,0,0,0,0,0,
        0,0,0,0,0,0,0,0,0,0,0,0,0,0,0,0,0,0,0,0,0,0,0,0,0,0,0,0,0,0,0,0,0,0,0,0,0,0,0,0,
        0,0,0,0,0,0,0,0,0,0,0,0,0,0,0,0,0,0,0,0,0,0,0,0,0,0,0,0,0,0,0,0,0,0,0,0,0,0,0,0,
        361,361,345,305,305,305,305,346,361,345,305,305,305,305,305,346,361,345,305,305,305,305,305,346,361,345,305,305,305,305,305,346,361,361,361,361,361,361,361,361,
        441,441,442,64,64,64,64,440,344,442,64,64,64,64,64,440,344,442,64,64,64,64,64,440,344,442,64,64,64,64,64,440,282,280,280,280,280,280,280,280,
        0,0,0,0,0,0,0,0,464,0,0,0,0,0,0,52,424,51,0,0,0,0,0,64,464,64,0,0,0,0,0,52,400,280,280,280,280,280,280,280,
        0,0,0,0,0,0,0,0,0,0,0,0,0,0,0,52,424,51,0,0,0,0,0,0,0,0,0,0,0,0,0,52,400,280,280,280,280,280,280,280,
        0,0,0,0,0,0,0,0,0,0,0,0,0,0,0,52,424,51,0,0,0,0,0,0,0,0,0,0,0,0,0,52,400,280,280,280,280,280,280,280,
        0,0,0,0,0,0,0,0,0,0,0,0,0,0,0,52,424,51,0,0,0,0,0,0,0,0,0,0,0,0,0,52,400,280,280,280,280,280,280,280,
        0,0,0,0,0,0,0,0,0,0,0,0,0,0,0,0,464,0,0,0,0,0,0,0,0,0,0,0,0,0,0,52,400,280,280,280,280,280,280,280,
        0,0,0,0,0,0,0,0,0,0,0,0,0,0,0,0,0,0,0,0,0,0,0,0,0,0,0,0,0,0,0,52,400,280,280,280,280,280,280,280,
        0,0,0,0,0,0,0,0,0,0,0,0,0,0,0,0,0,0,0,0,0,0,0,0,0,0,0,0,0,0,0,52,400,280,280,280,280,280,280,280,
        0,0,0,0,0,0,0,0,0,0,0,0,0,0,0,0,0,0,0,0,0,0,0,0,0,0,0,0,0,0,0,52,400,280,280,280,280,280,280,280,
        0,0,0,0,0,0,0,0,0,0,0,0,0,0,0,0,0,0,0,0,0,0,0,0,0,0,0,0,0,0,0,52,400,280,280,280,280,280,280,280,
        0,0,0,0,0,0,0,0,0,0,0,0,0,0,0,0,0,0,0,0,0,0,0,0,0,0,0,0,0,0,0,52,400,280,280,280,280,280,280,280,
        0,0,0,0,0,0,0,0,0,0,0,0,0,0,0,0,0,0,0,0,0,0,0,0,0,0,0,0,0,0,0,52,400,280,280,280,280,280,280,280,
        0,0,0,0,0,0,0,0,384,0,0,0,0,0,0,0,0,0,0,0,0,0,0,0,384,0,0,0,0,0,0,52,400,280,280,280,280,280,280,280,
        0,0,0,0,0,0,0,0,424,51,0,0,0,0,0,0,0,0,0,0,0,0,0,52,424,51,0,0,0,0,0,52,400,280,280,280,280,280,280,280,
        0,0,0,0,0,0,0,0,424,51,0,0,0,0,0,0,0,0,0,0,0,0,0,52,424,51,0,0,0,0,0,52,400,280,280,280,280,280,280,280,
        0,0,0,0,0,0,0,0,424,51,0,0,0,0,0,0,0,0,0,0,0,0,0,52,424,51,0,0,0,0,0,52,400,280,280,280,280,280,280,280,
        0,0,0,0,0,0,0,0,424,51,0,0,0,0,0,0,0,0,0,0,0,0,0,52,424,51,0,0,0,0,0,52,400,280,280,280,280,280,280,280,
        0,0,0,0,0,0,0,0,424,51,0,0,0,0,0,0,0,0,0,0,0,0,0,52,424,51,0,0,0,0,0,52,400,280,280,280,280,280,280,280,
        0,0,0,0,0,0,0,0,424,51,0,0,0,0,0,0,384,0,0,0,0,0,0,52,424,51,0,0,0,0,0,52,400,280,280,280,280,280,280,280,
        0,0,0,0,0,0,0,0,424,51,0,0,0,0,0,52,424,51,0,0,0,0,0,52,424,51,0,0,0,0,0,52,400,280,280,280,280,280,280,280,
        361,361,361,361,361,361,361,361,479,362,63,63,63,63,63,360,466,51,0,0,0,0,0,52,465,362,63,63,63,63,63,360,322,280,280,280,280,280,280,280,
        280,280,280,280,280,280,280,280,280,321,361,361,361,361,361,322,402,51,0,0,0,0,0,52,400,321,361,361,361,361,361,322,280,280,280,280,280,280,280,280,
        280,280,280,280,280,280,280,280,280,280,280,280,280,280,280,280,402,51,0,0,0,0,0,52,400,280,280,280,280,280,280,280,280,280,280,280,280,280,280,280,
        280,280,280,280,280,280,280,280,280,280,280,280,280,280,280,280,402,51,0,0,0,0,0,52,400,280,280,280,280,280,280,280,280,280,280,280,280,280,280,280,
        280,280,280,280,280,280,280,280,280,280,280,280,280,280,280,280,402,51,0,0,0,0,0,52,400,280,280,280,280,280,280,280,280,280,280,280,280,280,280,280],
    "name": "The Living Dead End"
 }