{
    "tiles": [
        295,295,295,295,295,295,295,295,295,295,295,295,295,295,295,295,295,417,61,0,0,0,0,0,0,0,62,415,295,417,0,0,0,0,0,0,415,295,295,295,
        295,295,295,295,295,295,295,295,295,295,295,295,295,295,295,295,295,417,61,0,0,0,0,0,0,0,62,415,295,417,0,0,0,0,0,0,415,295,295,295,
        295,295,295,295,295,295,295,295,295,295,295,295,295,295,295,295,295,417,61,0,0,0,0,0,0,0,62,415,295,417,0,0,0,0,0,0,415,295,295,295,
        456,456,456,456,456,456,456,456,456,456,456,456,456,456,456,456,297,417,61,0,0,0,0,0,0,0,62,415,295,417,0,0,0,0,0,0,415,295,295,295,
        74,74,74,74,74,74,74,74,74,74,74,74,74,74,74,74,415,417,61,0,0,0,0,0,0,0,62,415,295,417,0,0,0,0,0,0,415,295,295,295,
        0,0,0,0,0,0,0,0,0,0,0,0,0,0,0,0,415,417,61,0,0,0,0,0,0,0,62,415,295,417,0,0,0,0,0,0,415,295,295,295,
        0,0,0,0,0,0,0,0,0,0,0,0,0,0,0,0,415,417,61,0,0,0,0,0,0,0,62,415,295,417,0,0,0,0,0,0,415,295,295,295,
        0,0,0,0,0,0,0,0,0,0,0,0,0,0,0,0,415,417,61,0,0,0,0,0,0,0,62,415,295,417,0,0,0,0,0,0,415,295,295,295,
        0,0,0,0,0,0,0,0,0,0,0,0,0,0,0,0,455,457,0,0,0,0,0,0,0,0,0,455,456,457,0,0,0,0,0,0,415,295,295,295,
        0,0,0,0,0,0,0,0,0,0,0,0,0,0,0,0,0,0,0,0,0,0,0,0,0,0,0,0,0,0,0,0,0,0,0,0,415,295,295,295,
        0,0,0,0,0,0,0,0,0,0,0,0,0,0,0,0,0,0,0,0,0,0,0,0,0,0,0,0,0,0,0,0,0,0,0,0,415,295,295,295,
        0,0,0,0,0,0,0,0,0,0,0,0,0,0,0,0,0,0,0,0,0,0,0,0,0,0,0,0,0,0,0,0,0,0,0,0,415,295,295,295,
        0,0,0,0,0,0,0,0,0,0,0,0,0,0,0,0,0,0,0,0,0,0,0,0,0,0,0,0,0,0,0,0,0,0,0,0,415,295,295,295,
        0,0,0,0,0,0,0,0,0,0,0,0,0,0,0,0,0,0,0,0,0,0,0,0,0,0,0,0,0,0,0,0,0,0,0,0,415,295,295,295,
        0,0,0,0,0,0,0,0,0,0,0,0,0,0,0,0,0,0,0,0,0,0,0,0,0,0,0,0,0,0,0,0,0,0,0,0,415,295,295,295,
        0,0,0,0,0,0,0,0,0,0,0,0,0,0,0,0,0,0,0,0,0,0,0,0,0,0,0,0,0,0,0,0,0,0,0,0,415,295,295,295,
        0,0,0,0,0,0,0,0,0,0,0,0,0,0,0,0,0,0,0,0,0,0,0,0,0,0,0,0,0,0,0,0,0,0,0,0,415,295,295,295,
        0,0,0,0,0,0,0,0,0,0,0,0,0,0,0,0,0,0,0,0,0,0,0,0,0,0,0,0,0,0,0,0,0,0,0,0,415,295,295,295,
        0,0,0,0,0,0,0,0,0,0,0,0,0,0,0,0,0,0,0,0,0,0,0,0,0,0,0,0,0,0,0,0,0,0,0,0,415,295,295,295,
        0,0,0,0,0,0,0,0,0,0,0,0,0,0,0,0,0,0,0,0,0,0,0,0,0,0,0,0,0,0,0,0,0,0,0,0,415,295,295,295,
        0,0,0,0,0,0,0,0,0,0,0,0,0,0,0,0,375,376,376,376,376,376,376,376,376,376,376,376,376,376,376,376,376,376,376,376,337,295,295,295,
        0,0,0,0,0,0,0,0,0,0,0,0,0,0,0,0,415,295,295,295,295,295,295,295,295,295,295,295,295,295,295,295,295,295,295,295,295,295,295,295,
        0,0,0,0,0,0,0,0,0,0,0,0,0,0,0,0,415,295,295,295,295,295,295,295,295,295,295,295,295,295,295,295,295,295,295,295,295,295,295,295,
        0,0,0,0,0,0,0,0,0,0,0,0,0,0,0,0,415,295,295,295,295,295,295,295,295,295,295,295,295,295,295,295,295,295,295,295,295,295,295,295,
        73,73,73,73,73,73,73,73,73,73,73,73,73,73,73,73,415,295,295,295,295,295,295,295,295,295,295,295,295,295,295,295,295,295,295,295,295,295,295,295,
        376,376,376,376,376,376,376,376,376,376,376,376,376,376,376,376,337,295,295,295,295,295,295,295,295,295,295,295,295,295,295,295,295,295,295,295,295,295,295,295,
        295,295,295,295,295,295,295,295,295,295,295,295,295,295,295,295,295,295,295,295,295,295,295,295,295,295,295,295,295,295,295,295,295,295,295,295,295,295,295,295,
        295,295,295,295,295,295,295,295,295,295,295,295,295,295,295,295,295,295,295,295,295,295,295,295,295,295,295,295,295,295,295,295,295,295,295,295,295,295,295,295,
        295,295,295,295,295,295,295,295,295,295,295,295,295,295,295,295,295,295,295,295,295,295,295,295,295,295,295,295,295,295,295,295,295,295,295,295,295,295,295,295,
        295,295,295,295,295,295,295,295,295,295,295,295,295,295,295,295,295,295,295,295,295,295,295,295,295,295,295,295,295,295,295,295,295,295,295,295,295,295,295,295],
    "name": "Standing Wave"
 }